abase	làm mất thể diện
abbess	nữ tu viện trưởng
abbey	tu viện
abbot	tu viện trưởng
abdicate	từ chức
abdomen	bụng
abdominal	bụng
abduction	bắt cóc
abed	cái giường
aberration	thác loạn
abet	đồng mưu
abeyance	hoản lại
abhorrence	điều gớm
abhorrent	đáng ghét
abidance	sự ở lại
abject	Khổ sở
abjure	bỏ giáo đạo
able-bodied	khỏe mạnh
ablution	lể rửa tội
abnegate	khước từ
abnormal	bất thường
abominable	đáng ghét
abominate	ghét
abomination	ghê gớm
aboriginal	bổn quốc
aborigines	thổ dân
aboveboard	ngay thẳng
abrade	cọ xát
abrasion	mài mòn
abridge	giãm bớt
abridgment	toát yếu
abrogate	bỏ
abrupt	đột ngột
abscess	nhọt
abscission	phép cắt đi
abscond	trốn tránh pháp luật
absence	vắng mặt
absent-minded	mất trí
absolution	tha tội
absolve	xá tội
absorb	hấp thụ
absorption	hấp thụ
abstain	Tránh ăn
abstemious	chừng mực
abstinence	kiêng cữ
abstruse	khó hiểu
absurd	vô lý
abundant	phong phú
abusive	mắng nhiếc
abut	giáp giới
abyss	vực sâu
academic	thuộc về lý thuyết
academician	hội viên hàn lâm viện
academy	học viện
accede	gia nhập
accelerate	Thúc giục
accept	Chấp nhận
access	truy cập
accessible	truy cập
accession	gia nhập
accessory	phụ kiện
acclaim	hoan hô
accommodate	chứa
accompaniment	hợp tấu
accompanist	người hòa âm
accompany	đồng hành
accomplice	đồng lõa
accomplish	đạt được
accordion	accordion
accost	níu kéo,
account	tài khoản
accouter	accouter
accredit	ủy nhiệm thơ
accumulate	tích trữ
accuracy	sự chính xác
accurate	chính xác
accursed	đáng ghét
accusation	buộc tội
accusatory	buộc tội
accuse	tố cáo
accustom	tập cho quen
acerbity	gay gắt
acetate	acetate
acetic	axetic
ache	nhức
Achillean	Achillean
achromatic	không phân biệt màu sắc
acid	chua
acidify	tính chua cay
acknowledge	công nhận
acknowledgment	nhìn nhận
acme	tối cao điểm
acoustic	acoustic
acquaint	Làm quen
acquiesce	đồng ý ngầm
acquiescence	sự bằng lòng
acquire	có được, thu được
acquisition	mua lại
acquit	làm xong
acquittal	sự làm tròn
acquittance	sự trả nợ
acreage	diện tích
acrid	chua cay
acrimonious	chua cay
acrimony	gay gắt
actionable	hành động
actuality	thực ra
actuary	thơ ký
actuate	xúi giục
acumen	sự nhạy bén
acute	nhọn
adamant	vật rất cứng
addendum	phụ lục
addle	ung hư
adduce	dẩn chứng
adhere	tuân thủ
adherence	dính
adherent	đảng viên
adhesion	bám dính
adieu	từ biệt
adjacency	phụ cận
adjacent	liền kề
adjudge	phân xử
adjunct	bổ sung từ
adjuration	van lơn
adjutant	phụ tá
administrator	người quản lý
admissible	chấp nhận được
admittance	lối đi vào
admonish	khiển trách
admonition	khuyên bảo
ado	khó nhọc
adoration	Yêu mến
adroit	khéo léo
adulterant	giả mạo
adulterate	pha không đúng
adumbrate	làm mờ
advent	xuất hiện
adverse	bất lợi
adversity	nghịch cảnh
advert	Quảng cáo
advertiser	nhà quảng cáo
advisory	tham mưu
advocacy	luật sư
advocate	biện hộ
aerial	trên không
aeronaut	người cởi khí cầu
aeronautics	thuật hàng không
aerostat	aerostat
aerostatics	khí tĩnh học
affable	dể thương
affect	có ảnh hưởng đến
affectation	không tự nhiên
affiliate	liên kết
affirmative	khẳng định
affix	đóng dấu
affluence	sung túc
affront	sự làm nhục
afire	Một đám cháy
afoot	đang tiến hành
aforesaid	nêu trên
afresh	lần nửa
afterthought	sự suy nghĩ
agglomerate	khoáng chất
aggrandize	phóng đại
aggravate	làm nặng thêm
aggravation	nặng hơn
aggregate	tập hợp
aggress	aggress
aggression	Hiếu chiến
aggrieve	làm buồn rầu
aghast	kinh ngạc
agile	nhanh nhẹn
agitate	khuấy động
agrarian	nông nghiệp
aide-de-camp	phụ tá-de-trại
ailment	bệnh tật
airy	thoáng đãng
akin	giống nhau
alabaster	ngọc thạch
alacrity	tính vui vẻ
albeit	dù
albino	người bạch tạng
album	album
alchemy	khoa luyện kim
alcohol	rượu
alcoholism	nghiện rượu
alcove	phần lõm của tường
alder	cây trăn
alderman	người đi bệ vệ
aldermanship	aldermanship
alias	tên giả
alien	người ngoài hành tinh
alienable	có thể sang
alienate	xa lánh
alienation	xa lánh
aliment	nuôi cho ăn
alkali	chất kiềm
allay	làm dịu bớt
allege	quả quyết
allegory	tượng trưng
alleviate	giảm bớt
alley	đường hẻm
alliance	đồng minh
allot	allot
allotment	sự phân phối
allude	ám chỉ
allusion	lời ám chỉ
alluvion	sự bồi đất
ally	đồng minh
almanac	lịch thư
aloof	đứng cách xa
altar	bàn thờ
alter	ALTER
alteration	sự biến đổi
altercate	cãi lộn
alternate	Luân phiên
alternative	thay thế
altitude	độ cao
alto	giọng hát cao thấp
altruism	lòng vị tha
altruist	chủ nghĩa vị tha
amalgam	hổn hợp với nhau
amalgamate	hổn hợp
amateur	nghiệp dư
amatory	thuộc về ái tình
ambidextrous	người gian xảo
ambiguous	mơ hồ
ambitious	đầy tham vọng
ambrosial	ambrosial
ambulance	xe cứu thương
ambulate	ambulate
ambush	mai phục
ameliorate	cải thiện
amenable	chịu trách nhiệm
Americanism	phong tục ở hoa kỳ
amicable	hòa giải
amity	thân thiện
amorous	ham mê
amorphous	vô định hình
amour	tình sự
ampere	am pe
ampersand	dấu và
amphibious	lội nước
amphitheater	giảng đường
amplitude	độ lớn
amply	đủ
amputate	cưa đi
amusement	vui chơi giải trí
anachronism	sự sai lầm
anagram	phép đố chử
analogous	giống nhau
analogy	sự giống nhau
analyst	chuyên gia phân tích
analyze	phân tích
anarchy	tình trạng hổn loạn
anathema	người bị nguyền rủa
anatomy	giải phẫu học
ancestry	tổ tiên
anecdote	chuyện vặt
anemia	thiếu máu
anemic	thân thể xanh xao
anemometer	phong kế
anesthetic	thuốc mê
anew	một lần nữa
angelic	thiên thần
Anglophobia	bài xích nước Anh
Anglo-Saxon	Anglo-Saxon
angular	có góc cạnh
anhydrous	khan
animadversion	sự khiển trách
animadvert	khiển trách
animalcule	vi sinh vật
animate	animate
animosity	sự thù oán
annalist	người viết lịch sử
annals	biên niên sử
annex	Phụ lục
annihilate	thủ tiêu
annotate	chú thích
annual	hàng năm
annuity	niên kim
annunciation	lời tuyên bố
anode	dương cực
anonymous	vô danh
antagonism	sự đối lập
Antarctic	Nam Cực
ante	ante
antecede	antecede
antecedent	lai lịch
antechamber	chờ vào yến kiến ​​người nào
antedate	sanh thiếu tháng
antediluvian	người xưa
antemeridian	thuộc về buổi sáng
antemundane	antemundane
antenatal	thai
anterior	trước
anteroom	phòng trước
anthology	văn tuyển
anthracite	than
anthropology	nhân chủng học
anthropomorphous	anthropomorphous
antic	sự nhảy lộn
Antichrist	phản đối cơ đốc giáo
anticlimax	anticlimax
anticyclone	gió thổi ngược
antidote	thuốc giải độc
antilogy	ý nghiả mâu thuẩn
antipathize	antipathize
antiphon	điệp ca
antiphony	antiphony
antipodes	nơi chống đối
antiquary	nhà khảo cổ
antiquate	kiễu cổ
antique	đồ cổ
antiseptic	khử trùng
antislavery	Chống nô lệ
antispasmodic	chống co thắt
antistrophe	antistrophe
antitoxin	kháng độc tố
antonym	từ trái nghĩa
anxious	áy náy
apathy	lạt lẽo
aperture	miệng vỏ
apex	đỉnh
aphorism	cách ngôn
apiary	nhà nuôi ong
apogee	chổ rất cao
apology	lời xin lỗi
apostasy	sự bỏ đạo
apostate	bỏ đạo
apostle	tông đồ
apothecary	người chế thuốc
apotheosis	sự sùng bái
appall	làm ghê sợ
apparent	hiển nhiên
apparition	xuất hiện
appease	nhân nhượng
appellate	phúc thẩm
appellation	tên gọi
append	append
appertain	về phận sự
apposite	thích hợp
apposition	sự ghép lại
appraise	thẩm định
appreciable	đáng kể
apprehend	bắt
apprehensible	có thể hiểu
approbation	sự thừa nhận
appropriate	thích hợp
aqueduct	máng nước
aqueous	có nước
arbiter	quan thẩm phán
arbitrary	Bất kỳ
arbitrate	phân xử
arbor	cây thông
arboreal	thuộc về cây cối
arborescent	arborescent
arboretum	vườn trồng cây
arboriculture	arboriculture
arcade	giải trí
archaic	xưa
archaism	tiếng xưa
archangel	nói về phật giáo
archbishop	tổng giám mục
archdeacon	phó giám mục
archaeology	khảo cổ học
archetype	khuôn mẫu
archipelago	quần đảo
ardent	cháy
ardor	nhiệt tình
arid	khô khan
aristocracy	quí tộc
aristocrat	người quí tộc
armada	hạm đội
armful	ôm vào lòng
armory	huy chương học
aroma	mùi thơm
arraign	tố cáo
arrange	sắp xếp
arrangement	sắp xếp
arrant	phi thường
arrear	tiền còn thiếu
arrival	đến
arrogant	kiêu ngạo
arrogate	đoạt lấy
Artesian	phun
artful	khéo léo
Arthurian	Arthur
artifice	mưu kế
artless	không khéo
ascendant	lên cao
ascension	hướng thượng
ascent	sự tiến bộ
ascetic	khổ tu
ascribe	thường gán
asexual	vô tính
ashen	tái mét
askance	nghiên
asperity	tính cộc cằn
aspirant	người ham muốn
aspiration	nguyện vọng
aspire	khao khát
assailant	người tấn công
assassin	kẻ ám sát
assassinate	ám sát
assassination	Sự am sát
assay	khảo nghiệm
assent	tán thành
assess	đánh giá
assessor	người định giá
assets	tài sản
assiduous	cần mẫn
assignee	nhận chuyển nhượng
assimilate	đồng hóa
assonance	vận nghèo
assonant	vận nghèo
assonate	assonate
assuage	làm cho dịu
astringent	co lại
astute	sắc sảo
atheism	thuyết vô thần
athirst	khát
athwart	xiên
atomizer	bình xịt thuốc
atone	chuộc lổi
atonement	sự chuộc tội
atrocious	gớm ghiếc
atrocity	tàn bạo
attache	tùy viên
attest	ATTEST
attorney-general	Bộ Trưởng Tư Pháp
auburn	màu nâu lợt
audacious	trơ tráo
audible	có thể nghe được
audition	thử vai
auditory	thính giác
augment	tăng
augur	chiêm tinh gia
Augustinian	Augustinô
aura	hào quang
aural	hơi xông lên
auricle	vành tai
auricular	thuộc về lổ tai
auriferous	có hàm chất vàng
aurora	rạng Đông
auspice	điềm tốt
austere	khắc khổ
autarchy	autarchy
authentic	xác thực
authenticity	xác thực
autobiography	hồi ký
autocracy	chánh thể chuyên chế
autocrat	nhà độc tài
automaton	automaton
autonomous	tự trị
autonomy	quyền tự trị
autopsy	Khám nghiệm tử thi
autumnal	thời kỳ suy đồi
auxiliary	phụ trợ
avalanche	lở tuyết
avarice	lòng tham lam
aver	súc vật chở nặng
averse	không thích
aversion	ghét
avert	Avert
aviary	lồng nuôi chim
avidity	sự thèm thuồng
avocation	nghề nghiệp
avow	bày tỏ
awaken	thức tỉnh
awry	không như ý
aye	vĩnh viển
azalea	Hoa đỗ quyên
azure	màu thanh thiên
Baconian	Baconian
bacterium	vi khuẩn
badger	người bán rong
baffle	làm trở ngại
bailiff	đại diện cho nhà vua
baize	nỉ bọc bàn ghế
bale	sự buồn rầu
baleful	không may
ballad	ballad
balsam	nhựa thơm
banal	tầm thường
barcarole	câu hát chèo
barograph	barograph
barometer	Áp kế
barring	ngăn
baritone	tiếng trầm
bask	tắm nắng
bass	âm bass
baste	rưới
baton	gậy
battalion	tiểu đoàn
batten	cây mè
batter	Bột nhồi
bauble	không gía trị
bawl	la
beatify	tôn chức hiển thánh
beatitude	chân phúc
beau	người si tình
becalm	bình tĩnh
beck	sự ra dấu
bedaub	bedaub
bedeck	trang sức
bedlam	nhà thương
befog	bao phủ
befriend	Làm bạn với
beget	gây ra
begrudge	ghen tị
belate	belate
belay	Belay
belie	không giử lời
believe	tin
belittle	chê
belle	mỷ nhân
bellicose	Hiếu chiến
belligerent	thuộc về chiến tranh
bemoan	phàn nàn
benediction	lể giáng phước
benefactor	làm việc từ thiện
benefice	đời sống giáo đường
beneficent	việc từ thiện
beneficial	có lợi
beneficiary	người thụ hưởng
benefit	lợi ích
benevolence	lòng từ thiện
benevolent	nhân từ
benign	nhẹ
benignant	hảo tâm
benignity	tánh hòa nhả
benison	Benison
bequeath	truyền cho
bereave	tước đoạt
berth	thả neo
beseech	cầu khẩn
beset	bao quanh
besmear	làm bẩn
bestial	thuộc về cầm thú
bestrew	rải rắc
bestride	Bestride
bethink	ngẩm nghỉ
betide	betide
betimes	sớm
betroth	hứa hôn
betrothal	lời hứa hôn
bevel	đi theo đường tà
bewilder	chưng hửng
bibliomania	ham mê sách
bibliography	thư mục
bibliophile	Người ham sách
bibulous	hút nước
bide	Bide
biennial	hai năm
bier	cái dá
bigamist	đàn ông hai vợ
bigamy	sự chung hai vợ
bight	phần lõm vào
bilateral	song phương
bilingual	nói hai thứ tiếng
biograph	Biograph
biography	tiểu sử
biology	sinh học
biped	có hai chân
birthright	quyền trưởng tử
bitterness	cay đắng
blase	chán
blaspheme	xúc phạm
blatant	om sòm
blaze	ngọn lửa
blazon	huy chương
bleak	ảm đạm
blemish	khuyết điểm
blithe	vui tươi
blithesome	yêu đời
blockade	sự phong tỏa
boatswain	thuyền trưởng
bodice	áo che thân trên
bodily	cơ thể
boisterous	người làm ồn ào
bole	thân cây
bolero	áo ngắn của đàn bà
boll	tỉa hột
bolster	ủng hộ
bomb	bom
bombard	Bombard
bombardier	oanh tạc cơ
bombast	văn lưu loát
boorish	sự quê mùa
bore	chán
borough	thành phố
bosom	ngực
botanical	thực vật học
botanize	nghiên cứu thực vật
botany	thực vật học
bountiful	khoan hồng
Bowdlerize	Bowdlerize
bowler	người chơi ném banh
boycott	tẩy chay
brae	giốc
braggart	hay khoe khoang
brandish	vung binh khí
bravado	ra vẻ
bravo	người đi ám sát
bray	lừa kêu
braze	làm giống sắc đồng
brazier	thợ làm đồng
breach	vi phạm
breaker	ngắt
breech	khóa nòng súng
brethren	anh trai
brevity	tính không bền
bric-a-brac	BRIC-a-Brac
bridle	cương ngựa
brigade	Lữ đoàn
brigadier	thiếu tướng
brigand	du côn
brimstone	diêm sanh
brine	nước muối
bristle	lông
Britannia	nước Anh
Briticism	cách nói riêng của tiếng Anh
brittle	dòn
broach	đồ dùng để dũa
broadcast	phát sóng
brogan	Brogan
brogue	giày đi núi
brokerage	môi giới
bromine	một hóa chất
bronchitis	viêm phế quản
bronchus	phế quản
brooch	trâm
brotherhood	tình huynh đệ
browbeat	dọa nạt
brusque	lỗ mãng
buffoon	tên hê
buffoonery	trò hề
bulbous	có hình củ hành
bullock	bò đực thiến
bulrush	cây bồ hoàng
bulwark	bao lơn
bumper	bội thu
bumptious	kiêu căng
bungle	việc làm vụng về
buoyancy	sự nổi
buoyant	vui vẻ
bureau	văn phòng
bureaucracy	quan liêu
burgess	người ở thành thị
burgher	người ở thành phố
burnish	đánh bóng
bursar	học sinh có học bổng
bustle	nhộn nhịp
butt	mông
butte	butte
buttress	bạnh vè
by-law	bởi rể
cabal	âm mưu
cabalism	cabalism
cabinet	buồng
cacophony	câu nhiều âm không hòa hợp
cadaverous	tái mét
cadence	nhịp
cadenza	Cadenza
caitiff	hèn hạ
cajole	nịnh hót
cajolery	sự tán tỉnh
calculable	có thể tính
calculus	calculus
callosity	tàn nhẩn
callow	chổ lủng thấp
calorie	nhiệt lượng
calumny	lời vu khống
Calvary	Calvary
Calvinism	Calvin
Calvinize	Calvinize
came	đến
cameo	cameo
campaign	chiến dịch
Canaanite	Canaan
canary	chim hoàng yến
candid	thật thà
candor	sự thẳng thắn
canine	giống chó
canon	canon
cant	không thể
cantata	nhạc phổ theo bài thơ
canto	đoạn ca
cantonment	chia quân ở nơi có dân cư
capacious	chứa thật nhiều
capillary	mao quản
capitulate	đầu hàng
caprice	bản nhạc phóng túng
caption	lời chú thích
captious	hay câu nệ
captivate	Captivate
carcass	thịt
cardiac	tim
cardinal	chủ yếu
caret	dấu viết in
caricature	cách vẻ hoạt kê
carnage	sự chém giết
carnal	thuộc về xác thịt
carnivorous	ăn thịt
carouse	say sưa
carrion	hôi thúi
cartilage	xương sụn
cartridge	hộp đạn
caste	đẳng cấp
castigate	gọt giũa
casual	binh thương
casualty	tai nạn
cataclysm	đại hồng thủy
cataract	đục thủy tinh thể
catastrophe	Thảm khốc
cathode	âm cực
Catholicism	đạo thiên chúa
catholicity	xóm đạo
cat-o-nine-tails	mèo-o-nine-đuôi
caucus	ủy ban địa phương
causal	nguyên nhân
caustic	caustic
cauterize	sự đốt bằng sắt
cede	nhường lại
censor	giám thị ở trường đại học
censorious	chỉ trích
census	điều tra dân số
centenary	trăm năm
centiliter	centiliter
centimeter	centimet
centurion	centurion
cereal	ngũ cốc
ceremonial	nghi thức
ceremonious	quá cậu nệ
cessation	đình chỉ
cession	vật chuyển nhượng
chagrin	nổi phiền muộn
chameleon	con tắc kè
chancery	Chancery
chaos	sự hỗn loạn
characteristic	đặc tính
characterize	đặc trưng
charlatan	lang băm
chasm	hang sâu
chasten	tự phụ
chastise	trừng phạt
chastity	trinh tiết
chateau	lâu đài
chattel	đồ vật trong nhà
check	kiểm tra
chiffon	voan
chivalry	chỉ những hiệp sĩ
cholera	dịch tả
choleric	hay giận
choral	hợp xướng
Christ	Đấng Christ
christen	chịu phép rửa tội
Christendom	tín đồ Cơ đốc giáo
chromatic	thuộc về màu sắc
chronology	niên đại
chronometer	thi kế
cipher	mật mã
circulate	lưu hành
circumference	đường tròn
circumlocution	nói dài lê thê
circumnavigate	đi vòng quanh
circumscribe	định giới hạn
circumspect	thận trọng
citadel	Thành lũy
cite	dẫn chứng
claimant	người thỉnh cầu
clairvoyance	sự minh mẫn
clamorous	la vang
clan	tộc
clandestine	gian lận
clangor	tiếng chói tai
clarify	làm rõ
clarion	oang oang
classify	classify
clearance	giải tỏa
clemency	khoan dung
clement	khí hậu ôn hòa
close-hauled	cận kéo
clothier	người bán quần áo may sẳn
clumsy	hậu đậu
coagulate	đặc lại
coagulant	đông lại
coalescence	sự hóa hợp
coalition	sự liên minh
coddle	nưng niu
codicil	codicil
coerce	ép buộc
coercion	sự ép buộc
coercive	cưỡng bách
cogent	vửng chắc
cognate	bà con
cognizant	hiểu biết
cohere	làm cho dính lại
cohesion	sự gắn kết
cohesive	tính kết hợp
coincide	trùng
coincidence	trùng
coincident	trùng hợp
collaborate	hợp tác
collapse	sự sụp đổ
collapsible	có thể xếp
colleague	đồng nghiệp
collective	tập hợp
collector	người sưu tầm
collegian	tù nhân
collide	va chạm
collier	thợ mỏ than
collision	va chạm
colloquial	thông thường
colloquialism	câu nói thân mật
colloquy	hội đàm
collusion	sự thông đồng
colossus	pho tượng
comely	hòa nhã
comestible	đồ ăn
comical	lố bịch
commemorate	kỷ niệm
commentary	bình luận
commingle	trộn lộn
commissariat	tiếp tế lương thực
commission	Uỷ ban
commitment	lời cam kết
committal	tống giam
commodity	hàng hóa
commotion	bạo động
commute	đi làm
comparable	có thể so sánh
comparative	tương đối
comparison	sự so sánh
compensate	đền bù
competence	thẩm quyền
competent	có thẩm quyền
competitive	cạnh tranh
competitor	đối thủ
complacence	sự bằng lòng
complacent	tự mãn
complaisance	sốt sắng
complaisant	tánh ân cần
complement	bổ sung
complex	phức tạp
compliant	compliant
complicate	phức tạp
complication	sự phức tạp
complicity	đồng lõa
compliment	lời khen
component	thành phần
comport	cư
composure	sự bình tỉnh
comprehensible	có thể hiểu được
comprehension	bao quát
comprehensive	toàn diện
compress	nén
compressible	chịu nén
compression	nén
comprise	bao gồm
compulsion	ép buộc
compulsory	bắt buộc
compunction	sự hối hận
compute	tính
concede	công nhận
conceit	tự cao
conceive	tưởng tượng
concerto	nhạc hợp tấu
concession	tô giới
conciliate	hòa giải
conciliatory	hòa giải
conclusive	quả quyết
concord	hòa thuận
concordance	sự phù hợp
concur	tán
concurrence	sự tranh đua
concurrent	đồng thời
concussion	sự rung chuyển
condensation	ngưng tụ
condense	cô đặc
condescend	chiếu cố
condolence	lời chia buồn
conduce	đưa đến
conducive	lợi
conductible	conductible
conduit	ống dẫn nước
confectionery	kẹo
confederacy	liên bang
confederate	liên minh
confer	trao
conferee	chuyện trò
confessor	người xưng tội
confidant	tri kỷ
confide	tâm sự
confidence	sự tự tin
confident	tự tin
confinement	sự giam cầm
confiscate	tịch thu
conflagration	nạn cháy lớn
confluence	hợp lưu
confluent	dính chùm
conformance	phù hợp
conformable	dể bảo
conformation	y theo
conformity	phù hợp
confront	đối đầu
congeal	đông đặc
congenial	tính chất giống nhau
congest	Làm tắc nghẽn
congregate	họp lại
coniferous	lọai cây tùng bách
conjecture	phỏng đoán
conjoin	nối tiếp
conjugal	sự liên hợp
conjugate	liên hợp
conjugation	kết hợp
conjunction	kết hợp
connive	thông đồng
connoisseur	người sành
connote	bao hàm
connubial	việc hôn nhơn
conquer	chinh phục
consanguineous	bà con
conscience	lương tâm
conscientious	tận tâm
conscious	Có ý thức
conscript	người bị bắt buộc
consecrate	dâng hiến
consecutive	liên tiếp
consensus	đoàn kết
conservatism	thuộc về bảo tồn
conservative	thận trọng
conservatory	giữ gìn
consign	ủy thác
consignee	nhận hàng
consignor	gửi hàng
consistency	Tính nhất quán
console	console
consolidate	củng cố
consonance	sự cộng hưởng
consonant	phụ âm
consort	cùng đi một hướng
conspicuous	dễ thấy
conspirator	người âm mưu
conspire	mưu phản
constable	nhân viên công lực
constellation	chòm sao
consternation	sự mất tinh thần
constituency	cử tri đoàn
constituent	thành phần
constrict	siết lại
consul	lãnh sự
consulate	lãnh sự quán
consummate	hoàn hảo
consumption	sự tiêu thụ
consumptive	thuộc về bịnh phổi
contagion	bịnh truyền nhiểm
contagious	dễ lây lan
contaminate	làm ô uế
contemplate	thưởng ngoạn
contemporaneous	đồng thời
contemporary	đồng thời
contemptible	đáng khinh
contemptuous	khinh thường
contender	contender
contiguity	hai vật tiếp giáp
contiguous	gần kề
continence	trinh bạch
contingency	dự phòng
contingent	ngẫu nhiên
continuance	sự kéo dài
continuation	tiếp tục
continuity	liên tục
continuous	tiếp diễn
contort	vặn lại
contraband	sự buôn lậu
contradiction	sự mâu thuẩn
contradictory	trái ngược
contraposition	sự trái ngược nhau
contravene	làm trở ngại
contribution	sự đóng góp
contributor	người góp phần
contrite	ăn năn
contrivance	mưu kế
contrive	xoay sở
control	điều khiển
controller	điều khiển
contumacious	bướng
contumacy	xấc xược
contuse	làm có vết bầm
contusion	đụng dập
convalesce	điều dưỡng
convalescence	nghỉ dưỡng
convalescent	mới khỏi bịnh
convene	triệu tập
convenience	tiện
converge	hội tụ
convergent	hội tụ
conversant	thân giao
conversion	chuyển đổi
convertible	mui trần
convex	lồi
conveyance	chuyên chở
convivial	vui vẻ
convolution	sự quấn lại
convolve	cây dây leo
convoy	hộ tống
convulse	làm co quắp
convulsion	sự lay chuyển
copious	dồi dào
coquette	đàn bà hay làm dáng
cornice	đường viền tròn
cornucopia	dồi dào
corollary	hệ luận
coronation	đăng quang
coronet	đồ trang sức
corporal	sự tuyên thệ
corporate	đoàn thể
corporeal	vật chất hửu tình
corps	quân đoàn
corpse	tử thi
corpulent	mập mạp
corpuscle	vi thể
correlate	tương quan
correlative	tương quan
corrigible	chửa được
corroborate	làm chứng cho
corroboration	làm chắc chắn
corrode	ăn mòn
corrosion	sự ăn mòn
corrosive	ăn mòn
corruptible	hư hỏng
corruption	tham nhũng
cosmetic	mỹ phẩm
cosmic	rộng mênh mông
cosmogony	cosmogony
cosmography	vủ trụ học
cosmology	vủ trụ luận
cosmopolitan	khắp thế giới
cosmopolitanism	chủ nghỉa thế giới
cosmos	vũ trụ
counter-claim	yêu cầu phản tố
counteract	chống lại
counterbalance	trái cân
countercharge	sự kiện ngược lại
counterfeit	giả mạo
counterpart	bản sao
countervail	làn cân bằng
counting-house	phòng Tài vụ
countryman	đồng hương
courageous	can đảm
course	khóa học
courser	trường đua
courtesy	lịch sự
covenant	khế ước
covert	che giấu
covey	đoàn người
cower	khúm núm
coxswain	lái tàu
crag	núi đá vóc đứng hiểm trở
cranium	sọ
crass	hoàn toàn dốt
craving	thèm muốn
creak	tiếng kêu kèn kẹt
creamery	chổ bán bơ
creamy	mịn
credence	lòng tin
credible	đáng tin
credulous	dể tin
creed	tín điều
crematory	nhà hỏa táng
crevasse	chổ nứt nẻ
crevice	đường nứt, kẽ hở
criterion	tiêu chuẩn
critique	bài phê bình
crockery	bát đĩa bằng sành
crucible	nồi nấu kim loại
crusade	cuộc vận động
crustacean	giáp xác
crustaceous	crustaceous
cryptogram	loại ẩn hoa
crystallize	Crystallize
cudgel	gậy
culinary	ẩm thực
cull	người khờ dại
culpable	có tội
culprit	thủ phạm
culvert	cống nước
cupidity	tánh tham lam
curable	có thế chửa khỏi
curator	người quản lý
curio	vật hiếm có
cursive	chữ ẩu
cursory	qua loa
curt	cộc lốc
curtail	hạn chế
curtsy	chào người nào
cycloid	đường cyc lo it
cygnet	chim thiên nga con
cynical	Hoài nghi
cynicism	sự thô tục
cynosure	các chòm sao
daring	gan
darkling	tối tăm
Darwinism	tiến hóa luận
dastard	người nhút nhát
datum	dữ kiện
dauntless	không sợ
day-man	ngày-người đàn ông
dead-heat	dead-nhiệt
dearth	thiếu
death's-head	sự khởi đầu của cái chết
debase	giảm giá trị
debatable	có thể tranh luận
debonair	phóng khoáng
debut	khởi đầu
decagon	hình mười góc
decagram	mười gờ ram
decaliter	mười lít
decalogue	thập giới
Decameron	Decameron
decameter	mười thước
decamp	bỏ trốn
decapitate	Decapitate
decapod	loại thập túc
decasyllable	decasyllable
deceit	nói dối
deceitful	giả dối
deceive	lừa dối
decency	Đứng đắn
decent	phong nha
deciduous	phù du
decimal	số thập phân
decimate	phá huỷ phần lớn
decipher	giải mã
decisive	quyết định
declamation	lối khoa trương
declamatory	khoa trương
declarative	declarative
declension	biến cách
decorate	trang trí
decorous	đoan trang
decoy	dụ dổ
decrepit	già yếu
dedication	sự cống hiến
deduce	suy luận
deface	làm hư
defalcate	thụt kết
defamation	làm tổn hại
defame	phỉ báng
default	mặc định
defendant	bị cáo
defensible	phòng thủ được
defensive	phòng ngự
defer	hoãn lại
deference	tôn kính
defiant	khiêu khích
deficiency	sự thiếu hụt
deficient	thiếu
definite	xác định
deflect	chệch hướng
deforest	phá rừng
deform	biến dạng
deformity	méo mó
defraud	ăn gian
defray	trả phí tổn thế cho ai
degeneracy	sự thoái hóa
degenerate	thoái hóa
degradation	suy thoái
degrade	suy thoái
dehydrate	mất nước
deify	sùng bái như thần
deign	đoái
deist	người theo thần giáo
deity	thần linh
deject	phiền muộn
dejection	sự buồn rầu
delectable	khoái trá
delectation	lạc thú
deleterious	bại hoại phong tục
delicacy	tinh vi
delineate	phác họa
deliquesce	deliquesce
delirious	nói không tỉnh táo
delude	lường gạt
deluge	trận lụt lớn
delusion	ảo tưởng
demagnetize	làm mất từ ​​lực
demagogue	người mị dân
demeanor	cách ăn ở
demented	điên
demerit	điều đáng chê
demise	cái chết của
demobilize	giải ngủ
demolish	phá hủy
demonstrable	có thể chứng minh
demonstrate	chứng minh
demonstrative	Biểu tình
demonstrator	người đi biểu tình
demulcent	làm bớt đau
demurrage	trể hạn
dendroid	đâm thành cành
dendrology	thụ mọc học
denizen	người ở xứ khác
denominate	chỉ tên
denomination	giáo phái
denominator	mẫu số
denote	chứng tỏ
denouement	đoạn kết
denounce	tố cáo
dentifrice	kem đánh răng
denude	làm trụi
denunciation	tuyên bố bãi ước
deplete	triệt binh
deplorable	thương tâm
deplore	lấy làm ân hận
deponent	cung khai
depopulate	làm giãm
deport	Deport
deportment	cách cư xử
deposition	lắng đọng
depositor	người gửi tiền
depository	lưu ký
deprave	làm xấu
deprecate	Ko tán thành
depreciate	phỉ báng
depreciation	sụt giá
depress	làm giảm xuống
depression	Phiền muộn
depth	chiều sâu
derelict	vô chủ
deride	chế nhạo
derisible	derisible
derision	chế nhạo
derivation	nguồn gốc
derivative	phát sinh
derive	lấy được
dermatology	da liễu
derrick	cần trục để hạ tàu
descendant	con cháu
descendent	hậu duệ
descent	hạ xuống
descry	nhận thấy
desert	Sa mạc
desiccant	hút ẩm
designate	chỉ định
desist	ngừng
desistance	desistance
despair	tuyệt vọng
desperado	NGƯỜI LIỀU MẠNG
desperate	tuyệt vọng
despicable	đáng khinh
despite	mặc dù
despond	tuyệt vọng
despondent	nản lòng
despot	bạo chúa
despotism	chế độ độc tài
destitute	nghèo khổ
desultory	rời rạc
deter	ngăn cản
deteriorate	hư hỏng
determinate	rỏ ràng
determination	sự quyết tâm
deterrent	ngăn cản
detest	ghét
detract	làm giảm uy tín
detriment	tổn hại
detrude	detrude
deviate	đi chệch
devilry	ảo thuật
deviltry	deviltry
devious	quanh co
devise	devise
devout	sùng đạo
dexterity	khéo tay
diabolic	ác hiểm
diacritical	phân biệt
diagnose	chẩn đoán
diagnosis	chẩn đoán
dialect	thổ ngữ
dialectician	nhà biện chứng học
dialogue	hội thoại
diaphanous	trong mờ
diatomic	có hai nguyên từ
diatribe	đấu khẩu
dictum	châm ngôn
didactic	giáo khoa
difference	Sự khác biệt
differentia	differentia
differential	vi phân
differentiate	Phân biệt
diffidence	thiếu tự tin
diffident	thiếu tự tin
diffusible	diffusible
diffusion	khuếch tán
dignitary	người có chức vị
digraph	chữ kết lại thành một âm
digress	lạc đề
dilapidated	đổ nát
dilate	giãn ra
dilatory	chậm chạp
dilemma	tình trạng khó xử
dilettante	tài tử
diligence	siêng năng
dilute	loãng
diminution	phòng giảm
dimly	lờ mờ
diphthong	Nguyên âm đôi
diplomacy	ngoại giao
diplomat	nhà ngoại giao
diplomatic	ngoại giao
diplomatist	nhà ngoại giao
disagree	không đồng ý
disallow	disallow
disappear	biến mất
disappoint	thất vọng
disapprove	không tán thành
disarm	giải giáp
disarrange	làm lộn xộn
disavow	từ chối
disavowal	không thừa nhận
disbeliever	người không tin ai
disburden	giải bày tâm sự
disburse	giải ngân
discard	loại bỏ
discernible	có thể nhận rỏ
disciple	môn sinh
disciplinary	kỷ luật
discipline	kỷ luật
disclaim	TỪ CHỐI
discolor	làm lu mờ
discomfit	làm bối rối
discomfort	khó chịu
disconnect	ngắt kết nối
disconsolate	ảm đạm
discontinuance	rời nhau
discord	bất hòa
discountenance	không tán thành
discover	Khám phá
discredit	mất uy tín
discreet	kín đáo
discrepant	sự chênh lệch
discriminate	phân biệt
discursive	rời rạc
discussion	thảo luận
disenfranchise	không quyên góp cho nhà thờ
disengage	buông tha
disfavor	không ưa
disfigure	làm xấu
dishabille	áo dài rộng của đàn bà
dishonest	Không trung thực
disillusion	tỉnh mộng
disinfect	Khử trùng
disinfectant	thuốc tẩy uế
disinherit	tước quyền
disinterested	vô tư
disjunctive	ly tiếp
dislocate	chia xẻ
dismissal	giải tán
dismount	làm ngã ngựa
disobedience	không vâng lời
disobedient	bất tuân
disown	disown
disparage	làm giãm giá trị
disparity	khác biệt
dispel	Dispel
dispensation	phân phát
displace	Displace
dispossess	trừ ma quỉ
disputation	cuộc tranh luận
disqualify	loại ra
disquiet	lo âu
disregard	xem thường
disreputable	làm ô danh
disrepute	tiếng xấu
disrobe	cởi quần áo
disrupt	phá vỡ
dissatisfy	bất mản
dissect	phân tích
dissection	sự mổ xẻ
dissemble	bỏ qua
disseminate	Phổ biến
dissension	phân tranh
dissent	bất đồng ý kiến
dissentient	người phản đối
dissentious	dissentious
dissertation	luận án
disservice	báo hại
dissever	chia ra
dissimilar	khác nhau
dissipate	tiêu tan
dissipation	phân tán
dissolute	phóng đãng
dissolution	giải tán
dissolve	hòa tan
dissonance	không hợp điệu
dissonant	chói tai
dissuade	khuyên can
dissuasion	sự khuyên can
disyllable	disyllable
distemper	sự đau
distend	phình lên
distensible	có thể làm nở
distention	làm phồng lên
distill	chưng cất
distillation	chưng cất
distiller	máy dùng để nấu
distinction	phân biệt
distort	xuyên tạc
distrain	tịch biên
distrainor	distrainor
distraught	điên cuồng
distrust	nghi ngờ
disunion	không thống nhất
diurnal	thuộc về Ban ngày
divagation	vơ vẩn
divergent	khác nhau
diverse	phong phú
diversion	dẫn dòng
diversity	đa dạng
divert	divert
divertible	divertible
divest	cởi quần áo
divination	thuật bói toán
divinity	thần
divisible	chia hết cho
divisor	số chia
divulge	tiết lộ
divulgence	divulgence
docile	ngoan ngoãn
docket	sổ ghi án
doe	con hoẳng cái
dogma	giáo lý
dogmatic	độc đoán
dogmatize	đạo lý
doleful	sầu thãm
dolesome	dolesome
dolor	dolor
dolorous	đau thương
domain	miền
domesticity	sự thuần phục
domicile	cư trú
dominance	ưu thế
dominant	có ưu thế
dominate	thống trị
domination	quyền thống trị
domineer	tỏ vẻ hách dịch
donate	tặng
donator	Donator
donee	người được tặng
donor	nhà tài trợ
dormant	không hoạt động
doublet	song lập
doubly	gấp đôi
dowry	của hồi môn
drachma	tiền cổ hy lạp
dragnet	lưới đánh cá
dragoon	dùng thủ đoạn
drainage	thoát nước
dramatist	nhà soạn kịch
dramatize	tác phẫm sửa đổi thành kịch bản
drastic	quyết liệt
drought	hạn hán
drowsy	buồn ngủ
drudgery	làm cực nhọc
dubious	mơ hồ
duckling	vịt con
ductile	tánh dể bảo
duet	song ca
dun	người đi đòi nợ
duplex	đôi
duplicity	sự hai lòng
durance	Durance
duration	thời gian
duteous	vâng lời
dutiable	tính thuế
dutiful	vâng lời
dwindle	giãm bớt
dyne	về vật lý
earnest	nghiêm trang
earthenware	đồ bằng đất
eatable	ăn được
ebullient	tánh bồng bột
eccentric	kỳ dị
eccentricity	độ lệch tâm
eclipse	nhật thực
economize	tiết kiệm
ecstasy	sự ngây ngất
ecstatic	ngây ngất
edible	ăn được
edict	pháp lịnh
edify	đạo đức
editorial	biên tập
educe	bay ra
efface	làm lu mờ
effect	hiệu ứng
effective	có hiệu lực
effectual	có hiệu qủa
effeminacy	effeminacy
effeminate	ẻo lả
effervesce	bồng bột
effervescent	hăng hái
effete	không hiệu qủa
efficacious	hiệu nghiệm
efficacy	hiệu quả
efficiency	hiệu quả
efficient	Có hiệu quả
efflorescence	rã thành bột
efflorescent	efflorescent
effluvium	effluvium
effrontery	vô liêm sĩ
effulgence	effulgence
effuse	rót ra
effusion	sự bày tỏ
egoism	tánh ích kỷ
egoist	người vị kỷ
egotism	tự phụ
egotist	thuyết tự ngã chí thượng
egregious	phi thường
egress	đi ra
eject	eject
elapse	trôi mau
elasticity	đàn hồi
electrolysis	điện
electrotype	bản in bằng điện
elegy	bài hát ta thán
element	thành phần
elicit	gợi ra
eligible	đủ điều kiện
eliminate	bỏ
Elizabethan	Elizabethan
elocution	văn thể
eloquent	có tài hùng biện
elucidate	Làm sáng tỏ
elude	trốn tránh
elusion	elusion
emaciate	hốc hác
emanate	xông lên
emancipate	phóng thích
embargo	ngăn cấm
embark	tham gia
embarrass	lúng túng
embellish	tô điểm
embezzle	biển thủ
emblazon	đeo huy chương
emblem	biểu tượng
embody	hiện thân
embolden	dũng cảm
embolism	chứng tắc quản
embroil	làm lộn xộn
emerge	hiện ra
emergence	sự xuất hiện
emergent	ló ra
emeritus	danh dự
emigrant	người di cư
emigrate	di cư
eminence	mô đất
eminent	nổi tiếng
emit	Emit
emphasis	nhấn mạnh
emphasize	nhấn mạnh
emphatic	giọng hống hách
employee	Nhân viên
employer	sử dụng lao động
emporium	trung tâm thương mại
empower	trao quyền
emulate	thi đua
enact	ban hành
enamor	enamor
encamp	Encamp
encomium	Lời khen ngợi
encompass	Encompass
encore	lần nữa
encourage	khuyến khích
encroach	lấn đất
encumber	ngăn trở
encyclical	Thông điệp
encyclopedia	Bách khoa toàn thư
endanger	gây nguy hiểm
endear	thân mật
endemic	đặc hữu
endue	ban cho
endurable	dẻo dai
endurance	sức chịu đựng
energetic	năng lượng
enervate	không có nghị lực
enfeeble	Enfeeble
enfranchise	phóng thích
engender	gây ra
engrave	khắc
engross	sao
enhance	nâng cao
enigma	câu đố
enjoin	ra lịnh
enkindle	xúi dục
enlighten	minh bạch
enlist	chiêu mộ
enmity	thù hận
ennoble	cao thượng
enormity	tội nặng
enormous	khổng lồ
enrage	Tức giận
enrapture	mừng quýnh
enshrine	cất giữ
ensnare	Ensnare
entail	đòi hỏi
entangle	entangle xảy ra
enthrall	say mê
enthrone	tôn lên ngôi
enthuse	đam mê
enthusiastic	nhiệt tâm
entirety	trọn vẹn
entomology	côn trùng
entrails	ruột
entreaty	khẩn cầu
entree	đi vào
entrench	đắp lủy
entwine	ôm chặt
enumerate	enumerate
epic	sử thi
epicure	người sành ăn
Epicurean	Epicurean
epicycle	ngoại luân
epicycloid	ngoại hải tuyến
epidemic	bệnh dịch
epidermis	da ngoài
epigram	lời chế nhạo
epilogue	diển văn
epiphany	hiển linh
episode	tập phim
epitaph	chữ khắc trên mộ
epithet	hình dung từ
epitome	trích yếu
epizootic	bịnh dịch thú
epoch	kỷ nguyên
epode	epode
equalize	Equalize
equanimity	bình thản
equestrian	người cỡi ngựa
equilibrium	thế cân bằng
equitable	công bình
equity	công bằng
equivalent	tương đương
equivocal	không phân minh
equivocate	không phân minh
eradicate	nhổ tận gốc
errant	lang thang
erratic	không đều
erroneous	sai
erudite	uyên bác
erudition	sự uyên bác
eschew	tránh
espy	thoạt nhìn
esquire	Ngài
essence	Bản chất
esthetic	thuộc về mỹ thuật
estimable	đáng mến
estrange	giận người nào
estuary	cửa sông
et	et
eugenic	sự giao hợp hai giống khác nhau
eulogize	tán dương
eulogy	tán thưởng
euphemism	uyển khúc ngữ pháp
euphonious	êm tai
euphony	sự hòa âm
eureka	eureka
evade	né tránh
evanesce	biến mất
evanescent	biến mất
evangelical	Tin Mừng
evangelist	người truyền giáo
evasion	trốn
eventual	cuối cùng
evert	lộn từ trong ra ngoài
evict	đuổi
evidential	chứng tích
evince	tỏ ra
evoke	Evoke
evolution	sự phát triển
evolve	tiến hóa
exacerbate	trầm trọng thêm
exaggerate	thổi phồng
exasperate	làm đau thêm
excavate	đào
exceed	quá
excel	excel
excellence	xuất sắc
excellency	xuất chúng
excellent	thông minh
excerpt	đoạn trích
excess	thặng dư
excitable	dể bị kích thích
excitation	kích thích
exclamation	cảm thán
exclude	loại trừ
exclusion	loại trừ
excrescence	cục bứu
excretion	sự bài tiết
excruciate	hành hạ
excursion	du ngoạn
excusable	có thể tha thứ
execrable	đáng ghét
execration	ghét đắng
executor	người thi hành
exegesis	lời giải thích
exemplar	khuôn
exemplary	làm gương
exemplify	nêu gương, lam mâu mực
exempt	miễn
exert	gắng sức
exhale	thở ra
exhaust	thoát ra
exhaustible	có thể bị hao mòn
exhaustion	kiệt sức
exhaustive	đầy đủ
exhilarate	hoạt động lại
exhume	moi lên
exigency	việc bất ngờ
exigent	khẩn cấp
existence	đời
exit	lối ra
exodus	cuộc di cư
exonerate	tha
exorbitance	quá độ
exorbitant	quá đáng
exorcise	trừ tà ma
exotic	kỳ lạ
expand	phát triển
expanse	khoảng rộng
expansion	sự bành trướng
expatriate	bỏ quốc tịch
expect	chờ đợi
expectancy	thọ
expectorate	khạc nhổ
expediency	phương tiện
expedient	láu cá
expedite	giục
expeditious	giản tiện
expend	xài
expense	kinh phí
expiate	chuộc tội
explicate	cắt nghỉa
explicit	minh bạch
explode	nổ tung
explosion	tiếng nổ
explosive	nổ
exposition	triển lãm
expository	bình luận
expostulate	khuyên can
exposure	sự phơi nhiễm
expressive	biểu cảm
expulsion	trục xuất
extant	còn sót lại
extemporaneous	ứng khẩu
extempore	làm lập tức
extensible	mở rộng
extension	sự mở rộng
extensive	sâu rộng
extensor	duổi ra
extenuate	làm suy nhược
exterior	ngoài
external	ngoài
extinct	tắt
extinguish	dập tắt
extol	khen ngợi
extort	tống tiền
extortion	tống tiền
extradite	bắt và giao trả
extradition	dẫn độ
extrajudicial	phi pháp
extraneous	không liên quan
extraordinary	phi thường
extravagance	hoang phí
extravagant	hoang phí
extremist	cực đoan
extremity	ngọn cây
extricate	thoát ra
extrude	đuổi
exuberance	dồi dào
exuberant	phong phú
fabricate	Chế tạo
fabulous	hoang đường
facet	mặt nhỏ
facetious	khôi hài
facial	ở mặt
facile	dể chịu
facilitate	tạo điều kiện
facility	cơ sở
facsimile	mô phỏng
faction	đảng phái
factious	thuộc về đảng phái
fallacious	giả dối
fallacy	lối ngụy biện
fallible	có thể làm lổi
fallow	đất bỏ hoang
famish	bỏ đói
fanatic	người cuồng tín
fancier	người sành sỏi
fanciless	fanciless
fastidious	khó tánh
fathom	ôm chặt
fatuous	khờ dại
faulty	sai lầm
faun	thần điền dã
fawn	hươu con
fealty	lời thề trung thành
feasible	thực hiện được
federate	liên hiệp
feint	sự làm bộ
felicitate	khen ngợi
felicity	hạnh phúc
felon	dữ tợn
felonious	phạm tội sát nhân
felony	tội
feminine	giống cái
fernery	chổ có nhiều cây dương xỉ
ferocious	hung dữ
ferocity	hung ác
fervent	nhiệt tâm
fervid	sốt sắng
fervor	sự hăng hái
festal	thuộc về ngày lể
festive	vui vẻ
fete	ngày lể
fetus	thai nhi
feudal	chế độ phong kiến
feudalism	chế độ phong kiến
fez	thứ mũ của thổ nhỉ kỳ
fiasco	thất bại hoàn toàn
fickle	hay thay đổi
fictitious	tưởng tượng
fidelity	lòng trung thành
fiducial	giao thác di sản
fief	thái ấp
filibuster	bọn giặc biển
finale	finale
finality	tính chất dứt khoát
finally	cuối cùng
financial	tài chính
financier	người xuất vốn
finery	luyện kim khí
finesse	Sự khéo léo
finite	có hạn
fiscal	ngân sách
fishmonger	người bán cá
fissure	đường nứt
fitful	tánh bất thường
fixture	vật cố định
flag-officer	cờ-đốc
flagrant	rõ ràng
flamboyant	Hoa phượng
flatulence	lòng tự phụ
flection	flection
fledgling	thiếu kinh nghiệm
flexible	Linh hoạt
flimsy	mỏng mảnh
flippant	suồng sả
floe	tảng nước đá trôi trên mặt biển
flora	thực vật
floral	hoa
florid	tươi như hoa
florist	người bán hoa
fluctuate	thay đổi
fluctuation	biến động
flue	thải
fluent	lưu loát
fluential	fluential
flux	tuôn ra
foggy	sương mù
foible	chổ yếu
foist	thêm vào
foliage	lá cây
folio	số trang của sách
folk-lore	dân gian truyền thuyết
fondle	vuốt ve
foolery	trò khôi hài
foot-note	chân-note
foppery	công tử bột
foppish	kiêu căng
forbearance	sự kiêng cử
forby	cho bởi
forcible	mạnh dạn
forecourt	trước tòa án
forejudge	trước vành móng ngựa
forepeak	forepeak
foreshore	bãi biển
forebode	chỉ điểm
forecast	dự báo
forecastle	phần mũi tàu đến cột buồm
foreclose	khai trừ
forefather	tổ tiên
forego	đi trước
foreground	vấn đề xung quanh
forehead	trán
foreign	ngoại quốc
foreigner	người nước ngoài
foreknowledge	tiên tri
foreman	người cai
foreordain	đoán trước
foreordination	foreordination
forerun	forerun
foresail	buồm ở phía trước
foresee	ForeSee
foresight	sự đoán trước
foretell	nói trước
forethought	tính toán cẩn thận
forfeit	đã mất lượt
forfend	forfend
forgery	sự giả mạo
forgo	từ bỏ
formation	sự hình thành
formidable	dữ dội
formula	công thức
forswear	từ bỏ
forte	sở trường
forth	trước
forthright	quả quyết
fortify	Fortify
fortitude	nghị lực
foursome	bốn người
fracture	gãy xương
fragile	dễ vỡ
frailty	lổi
frankincense	nhựa có mùi hương
frantic	điên cuồng
fraternal	như anh em
fraudulence	gian lận
fraudulent	gian lận
fray	cuộc xung đột
freemason	người đàn bà tự do
freethinker	tự do tư tưởng
free	miễn phí
frequency	tần số
fresco	bích họa
freshness	tươi mát
fretful	làm phiền
frightful	khủng khiếp
frigid	lạnh buốt xương
frigidarium	frigidarium
frivolity	nông nổi
frivolous	hư không
frizz	tóc uốn dợn
frizzle	chiên
frolicsome	hay vui đùa
frontier	biên giới
frowzy	dơ dáy
frugal	thanh đạm
fruition	kết quả
fugacious	thoáng qua
fulcrum	điểm tựa
fulminate	phun ra
fulsome	làm cho chán
fumigate	xông khói
functionary	viên chức
fundamental	căn bản
fungible	thể thay thế được
fungous	có hình nấm
fungus	nấm
furbish	chùi
furlong	đơn vị đo chiều dài
furlough	nghỉ phép
furrier	người bán da thú
further	thêm nữa
furtherance	Để thực
furtive	lén lút
fuse	cầu chì
fusible	nóng chảy
futile	vô ích
futurist	người theo chủ nghỉa vị lai
gauge	gauge
gaiety	vui tươi
gaily	vui vẻ
gait	dáng đi
gallant	dũng cảm
galore	nhiều qúa
galvanic	cười gượng
galvanism	lưu điện học
galvanize	mạ
gamble	cờ bạc
gambol	đùa giởn
gamester	người cờ bạc
gamut	âm giai
garnish	Trình bày
garrison	quân đội trú phòng
garrote	Garrote
garrulous	già chuyện
gaseous	khí
gastric	dạ dày
gastritis	chứng sưng dạ dày
gastronomy	nấu ăn ngon
gendarme	Gendarme
genealogy	phả hệ
genealogist	phả hệ học
generality	tổng quát
generalize	generalize
generally	nói chung là
generate	phát ra
generic	chung
generosity	rộng lượng
genesis	sự bắt đầu
geniality	sự tài ba
genital	cơ quan sinh dục
genitive	tánh cách
genteel	lịch sự
gentile	Gentile
geology	địa chất học
germane	Gecman
germinate	nảy mầm
gestation	có thai
gesticulate	bày tỏ
gesture	cử chỉ
ghastly	kinh khủng
gibe	chế giểu
giddy	ham chơi
gigantic	kếch sù
giver	người tặng
glacial	băng
glacier	băng hà
gladden	làm vui lòng
glazier	thợ lắp kính
glimmer	ánh sáng yếu dần
glimpse	nhìn thoáng qua
globose	tròn như quả cầu
globular	hình cầu
glorious	vẻ vang
glutinous	dính
gluttonous	tánh ham ăn
gnash	nghiến răng
Gordian	Gordian
gourmand	người sành ăn
gosling	ngỗng con
gossamer	sa
gourd	quả bầu
graceless	vô duyên
gradation	sự thêm bớt
gradient	dốc
granary	kho
grandeur	sự cao cả
grandiloquent	hay khoa trương
grandiose	vĩ đại
grantee	người nhận của tặng
grantor	người cho
granular	hột
granulate	kết tinh
granule	hột nhỏ
grapple	vật lộn
gratification	sự vừa lòng
gratify	làm vừa lòng
gratuitous	cho không
gratuity	tiền thưởng
gravity	Trọng lực
gregarious	thành bầy
grenadier	lính ném lựu đạn
grief	nỗi buồn
grievance	khiếu nại
grievous	đau khổ
grimace	nhăn nhó
grindstone	đá mài
grisly	ghê tởm
grotesque	kỳ quái
grotto	hang
ground	đất
guess	phỏng đoán
guile	lừa đảo
guileless	thành thật
guinea	guinea
guise	bề ngoài
gullible	dể tin
gumption	cách giao thiệp
gusto	thú làm việc
guy	chàng
guzzle	ăn tham
gynecocracy	gynecocracy
gynecology	phụ nhân học
gyrate	xoay quanh
gyroscope	máy con quay
habitable	có thể ở được
habitant	cư ngụ
habitual	thường lệ
habitude	thể chất
hackney	làm thành tầm thường
haggard	xanh xao
halcyon	chim sa
hale	mạnh khỏe
handwriting	chữ viết tay
hanger-on	tổ chức vì tư lợi
happy-go-lucky	hạnh phúc-đi-may mắn
harangue	đọc diển văn trước đám đông
harass	quấy rối
harbinger	điềm báo trước
hard-hearted	vô tình
hardihood	sự can đảm
harmonious	hài hòa
havoc	sự tàn phá
hawthorn	cây sơn trà
hazard	nguy hiểm
head	cái đầu
heartrending	đau lòng
heathenish	heathenish
heedless	không chú ý
heifer	bò cái tơ
heinous	hung bạo
hemorrhage	xuất huyết
hemorrhoids	bệnh trĩ
henchman	tay sai
henpeck	ăn hiếp chồng
heptagon	Thất giác
heptarchy	thất hùng chánh trị
herbaceous	thuộc về cỏ
herbarium	phòng sưu tập cỏ khô
herbivorous	ăn cỏ
hereditary	di truyền
heredity	thừa kế
heresy	Dị giáo
heretic	heretic
heritage	gia tài
hernia	bịnh sản khí
hesitancy	sự do dự
hesitant	do dự
hesitation	sự lưỡng lự
heterodox	trái với ý kiến
heterogeneity	không đồng nhất
heterogeneous	không đồng nhất
heteromorphic	dị hình
hexangular	hexangular
hexapod	hexapod
hexagon	Hình lục giác
hiatus	khuyết điểm
hibernal	thuộc về mùa đông
Hibernian	Hibernian
hideous	gớm guốc
hilarious	vui vẻ
hillock	đồi nhỏ
hinder	cản trở
hindmost	sau cùng
hindrance	cản trở
hirsute	xồm xoàm
hoard	tích trử
hoarse	giọng khan
homage	tôn kính
homogeneity	đồng thể
homogeneous	đồng tính
homologous	tương đồng
homonym	chữ đồng âm dị nghĩa
homophone	chữ đồng âm
honorarium	tiền công của bác sĩ
hoodwink	lừa phỉnh
horde	một tốp
hosiery	hàng dệt kim
hospitable	hiếu khách
hospitality	lòng hiếu khách
hostility	thù địch
huckster	người bán rong
humane	nhân đạo
humanitarian	nhân đạo
humanize	hóa thành nhân từ
humbug	mánh khoé
humiliate	làm nhục
hussar	khinh kỵ binh
hustle	chen lấn
hybrid	hỗn hợp
hydra	vật khó trừ tuyệt
hydraulic	thủy lực
hydrodynamics	thủy động học
hydroelectric	thủy điện
hydromechanics	hydromechanics
hydrometer	máy trắc thủy
hydrostatics	thủy tỉnh học
hydrous	ngậm nước
hygiene	vệ sinh
hypercritical	phê bình quá nghiêm khắc
hypnosis	thôi miên
hypnotic	thôi miên
hypnotism	thuật thôi miên
hypnotize	thôi miên
hypocrisy	đạo đức giả
hypocrite	đạo đức giả
hypodermic	dưới da
hypotenuse	cạnh huyền
hypothesis	giả thuyết
hysteria	thần kinh loạn
ichthyic	ichthyic
ichthyology	nghiên cứu về ngư loại học
ichthyosaurs	thằn lằn cá
icily	lãnh đạm
iciness	iciness
icon	biểu tượng
iconoclast	người đập phá cách
idealize	quan niệm hóa
idiom	cách diễn đạt
idiosyncrasy	khí chất
idolize	tôn thờ
ignoble	thấp hèn
ignominious	ô nhục
Iliad	Iliad
illegal	bất hợp pháp
illegible	không đọc được
illegitimate	không hợp pháp
illiberal	không rộng rải
illicit	trái phép
illimitable	vô hạn
illiterate	MU chư
ill-natured	hung ác
illogical	bất hợp lý
illuminant	soi sáng
illuminate	Illuminate
illumine	làm minh bạch
illusion	ảo giác
illusive	giả dối
illusory	hão huyền
imaginable	có thể tưởng tượng
imaginary	tưởng tượng
imbibe	hấp thụ
imbroglio	trạng thái rắc rối
imbrue	làm dơ
imitation	sự bắt chước
imitator	người hay bắt chước
immaculate	tinh khiết
immaterial	vô hình
immature	còn non nớt
immeasurable	bao la
immense	bao la
immerse	đắm
immersion	ngâm
immigrant	di trú
immigrate	di trú
imminence	sắp xảy ra
imminent	sắp xảy ra
immiscible	không thể trộn lộn
immoral	trái với đạo đức
immortalize	bất hủ
immovable	bất động
immune	miễn dịch
immutable	bất biến
impair	GIẢM KHẢ
impalpable	rất mịn
impartial	công bình
impassable	không thể qua
impassible	vô tình
impassive	trơ trơ
impatience	thiếu kiên nhẫn
impeccable	hoàn hảo
impecunious	túng tiền
impede	làm ngăn trở
impel	xô
impend	đang đe dọa
imperative	bắt buộc
imperceptible	không thể trông thấy
imperfectible	imperfectible
imperil	làm nguy hiểm
imperious	làm phách
impermissible	cấm
impersonal	nhân hóa
impersonate	mạo danh
impersuadable	impersuadable
impertinence	ngạo mạn
imperturbable	không chuyển động
impervious	không thấm nước
impetuosity	dử dội
impetuous	hung hăng
impetus	thúc đẩy
impiety	sự bất tín
impious	không tính ngưởng
implausible	không hợp lý
impliable	impliable
implicate	kết với nhau
implicit	ngầm
imply	bao hàm, ngụ ý
impolitic	thất sách
importation	nhập khẩu
importunate	làm khó chịu
importune	xin
impotent	bất lực
impoverish	suy nhược
impracticable	không thể áp dụng
impregnable	không thể cướp đoạt
impregnate	xâm nhập vào
impromptu	không sắp đặt trước
improper	không đúng
impropriety	không thích hợp
improvident	không dự liệu
improvise	improvise
imprudent	hờ hửng
impudence	lời nói vô liêm sĩ
impugn	phản đối
impulsion	cãm tình nhứt thời
impulsive	bốc đồng
impunity	trạng thái miển tội
impure	không trong sạch
impute	đổ tội
inaccessible	không thể tiếp cận
inaccurate	không chính xác
inactive	không hoạt động
inadequate	không thỏa đáng
inadmissible	không thể thừa nhận
inadvertent	vô ý
inadvisable	không lưu ý
inane	trống không
inanimate	vô hồn
inapprehensible	không giải thích được
inapt	không có tài trí
inarticulate	câm
inaudible	khó nghe
inborn	Bẩm sinh
inbred	tự nhiên
incandescence	sự đốt cháy
incandescent	chiếu sáng
incapacitate	bất tài
incapacity	không đủ năng lực
incarcerate	tống giam
incendiary	người đốt nhà
incentive	khích lệ
inception	khởi đầu
inceptive	sơ khai
incessant	không ngớt
inchmeal	từng bước
inchoate	chưa phát triển
inchoative	mở đầu
incidence	tỷ lệ mắc bệnh
incident	biến cố
incidentally	tình cờ
incinerate	thiêu
incipience	sự bắt đầu
incipient	mới bắt đầu
incisor	răng cửa
incite	Incite
incitement	xúi giục
incoercible	incoercible
incoherence	không dính nhau
incoherent	rời rạc
incombustible	không thể phá hủy
incomparable	có một không hai
incompatible	không tương thích
incompetence	không có khả năng
incompetent	không đủ năng lực
incomplete	chưa hoàn thiện
incomprehensible	không thể hiểu được
incompressible	bóp nhỏ lại
inconceivable	phi thường
incongruous	vô lý
inconsequential	không đáng kể
inconsiderable	không có giá trị
inconsistent	không tương xứng
inconstant	hay thay đổi
incontrovertible	không thể chối cải
inconvenient	bất tiện
indefensible	không thể giữ
indefinitely	vô thời hạn
indelible	không thế làm mất
indescribable	không thể tả
indestructible	không thể hủy diệt
indicant	indicant
indicator	chỉ số
indict	truy tố
indigence	bần cùng
indigenous	bản địa
indigent	nghèo khổ
indigestible	không tiêu
indigestion	chứng khó tiêu
indignant	tức giận
indignity	đê tiện
indiscernible	không thể nhận rỏ
indiscreet	không cẩn thận
indiscriminate	không phân biệt
indispensable	cần thiết
indistinct	không minh bạch
indivertible	indivertible
indivisible	không thể chia đúng
indolence	làm biếng
indolent	không đau
indomitable	bất khuất
induct	nhậm chức
indulgence	khoan hồng
indulgent	nhu nhược
inebriate	say
inedible	không thể ăn được
ineffable	không thể chỉ bảo được
inefficient	không hiệu quả
inefficiency	không hiệu quả
ineligible	không đủ tư cách
inept	đần độn
inert	bất động
inestimable	vô giá
inevitable	chắc chắn xảy ra
inexcusable	không thể thi hành
inexhaustible	vô hạn
inexorable	khó hiểu
inexpedient	không thích đáng
inexpensive	rẻ tiền
inexperience	tính thiếu kinh nghiệm
inexplicable	không thể giải thích
inexpressible	không diển tả được
inextensible	không được gia hạn
infallible	công hiệu
infamous	ô nhục
infamy	bẩn thỉu
inference	sự suy luận
infernal	âm phủ
infest	Infest
infidel	không tín ngưỡng
infidelity	sự không chung thủy
infinite	vô hạn
infinity	vô cực
infirm	tàn tật
infirmary	bệnh viện
infirmity	gắn vào
inflammable	cháy
inflammation	viêm
inflexible	không nao núng
influence	ảnh hưởng
influential	có ảnh hưởng
influx	dòng
infrequence	infrequence
infrequent	ít xảy ra
infringe	vi phạm
infuse	Infuse
infusion	truyền
ingenious	khéo léo
ingenuity	Khéo léo
ingenuous	ngây thơ
inglorious	không vẻ vang
ingraft	đem vào
ingratiate	lấy lòng
ingratitude	sự vong ân
ingredient	thành phần
inherence	tự nhiên
inherent	vốn có
inhibit	ức chế
inhospitable	không ưa
inhuman	vô nhân đạo
inhume	mai táng
inimical	nghịch
iniquity	sự bất công
initiate	khởi đầu
inject	bơm
injunction	lệnh
inkling	sự thoa mực
inland	nội địa
inlet	đầu vào
inmost	ở hầu hết các
innocuous	không hại
innovate	đổi mới
innuendo	ám chỉ
innumerable	vô số
inoffensive	không làm mất lòng
inopportune	không thích nghi
inquire	hỏi thăm
inquisition	sự tìm tòi
inquisitive	tò mò
inquisitor	người điều tra
inroad	sự xâm lấn
insatiable	không chán
inscribe	ghi lên
inscrutable	không dò xét được
insecure	không an toàn
insensible	chết ngất
insentient	không có cảm giác
inseparable	không thể tách rời
insidious	xảo quyệt
insight	sáng suốt
insignificance	không quan trọng
insignificant	tầm thường
insinuate	nhét nhẹ
insipid	vô vị
insistence	khăng khăng
insistent	van lơn
insolence	tính xấc láo
insolent	xấc xược
insomnia	mất ngủ
inspector	viên thanh tra
instance	trường hợp
instant	lập tức
instantaneous	tức thì
instigate	Xúi giục
instigator	người xúi giục
instill	để tâm đến
instructive	dạy
insufficiency	suy
insufficient	không đủ
insular	trí thức hẹp hòi
insulate	cách điện
insuperable	không thể thắng nổi
insuppressible	không thể cản
insurgence	nổi lên
insurgent	dâng lên
insurrection	cuộc nổi loạn
intangible	vô hình
integrity	chính trực
intellect	trí tuệ
intellectual	trí tuệ
intelligence	Sự thông minh
intelligible	minh bạch
intemperance	không điều độ
intension	sự tăng thêm
intensive	chuyên sâu
intention	mục đích
interact	tương tác với nhau
intercede	Intercede
intercept	đánh chặn
intercession	sự can thiệp
intercessor	người can thiệp
interdict	lịnh cấm
interim	tạm thời
interlocutor	người ói chuyện
interlude	lớp kịch ngắn
intermediate	Trung gian
interminable	vô cùng
intermission	lúc tạm nghĩ
intermit	ngừng lại
intermittent	gián đoạn
interpolation	nội suy
interpose	can thiệp vào
interposition	sự can thiệp
interpreter	thông dịch viên
interrogate	chất vấn
interrogative	nghi vấn
interrogatory	lấy khẩu cung
interrupt	làm gián đoạn
intersect	giao nhau
intervale	khoảng cách
intervene	can thiệp vào
intestacy	intestacy
intestate	không có làm
intestine	ruột
intimacy	tình thân mật
intimidate	dọa nạt
intolerable	không chịu nổi
intolerance	không khoan dung
intolerant	tánh cố chấp
intoxicant	làm say
intoxicate	xông lên đầu
intracellular	nội bào
intramural	ở trong thành
intrepid	gan dạ
intricacy	lộn xộn
intricate	lộn xộn
intrigue	âm mưu
intrinsic	nội tại
introductory	mở đầu
introgression	introgression
intromit	intromit
introspect	nội quan
introspection	sự tự xét
introversion	hướng nội
introvert	sống nội tâm
intrude	nhét
intrusion	xâm nhập
intuition	trực giác
inundate	làm ngập
inundation	ngập lụt
inure	làm cho quen
invalid	không hợp lệ
invalidate	vô hiệu
invaluable	vô giá
invariable	không thay đổi
invasion	cuộc xâm lăng
invective	lời chửi rủa
inveigh	chưởi
inventive	phát minh
inverse	ngược
inversion	sự đảo ngược
invert	đảo ngược
investigator	người điều tra
investor	người đầu tư
inveterate	thâm căn cố đế
invidious	không ưa
invigorate	thêm sinh lực
invincible	bất khả chiến bại
inviolable	bất khả xâm phạm
invoke	invoke
involuntary	không tự nguyện
involution	sự co hồi
involve	liên quan
invulnerable	bất khả xâm phạm
inwardly	bên trong
iota	iota
irascible	có tánh nóng nảy
irate	giận dữ
ire	giận dữ
iridescence	màu ánh kim
iridescent	óng ánh
irk	khó chịu
irksome	irksome
irony	trớ trêu
irradiance	irradiance
irradiate	chiếu xạ
irrational	không hợp lý
irreducible	tối giản
irrefragable	irrefragable
irrefrangible	irrefrangible
irrelevant	không thích hợp
irreligious	không tôn giáo
irreparable	không thể khắc phục
irrepressible	irrepressible
irresistible	không thể cưỡng lại
irresponsible	vô trách nhiệm
irreverence	bất kính
irreverent	Khiếm nhã
irreverential	irreverential
irreversible	không thể đảo ngược
irrigant	tưới rửa
irrigate	tưới
irritable	dễ cáu bẳn
irritancy	Gây Ung Thư
irritant	Chất kích thích
irritate	kích thích
irruption	irruption
isle	hòn đảo
islet	cù lao
isobar	Isobar
isochronous	đẳng thời
isolate	isolate
isothermal	đẳng nhiệt
itinerant	lưu động
itinerary	hành trình
itinerate	itinerate
jargon	biệt ngữ
jaundice	bệnh vàng da
jeopardize	gây nguy hiểm
Jingo	thế à
jocose	đùa bỡn
jocular	hài hước
joggle	vấu nối
journalize	nội động từ
jovial	vui vẻ
jubilation	sự vui sướng
judgment	phán quyết
judicature	bộ máy tư pháp
judicial	tư pháp
judiciary	cơ quan tư pháp
judicious	khôn ngoan
juggle	tung hứng
jugglery	trò lừa gạt
jugular	tĩnh mạch cảnh
juicy	lý thú
junction	giao lộ
juncture	điểm gặp nhau
junta	hội đồng tư vấn
juridical	pháp lý
jurisdiction	quyền hạn
jurisprudence	luật học
juror	người đã tuyên thệ
joust	cưỡi ngựa đấu thương
justification	sự biện hộ
juvenile	vị thành niên
juxtapose	để kề nhau
keepsake	vật kỷ niệm
kerchief	khăn tay
kernel	hạt nhân
kiln	lò nung
kiloliter	kiloliter
kilometer	km
kilowatt	một ngàn watt
kimono	kimono
kind-hearted	hảo tâm
kingling	kingling
kingship	vương vị
kinsfolk	bà con
knavery	sự bất lương
knead	nhào
knickknack	knickknack
knight	Hiệp sỹ
knighthood	giai cấp
laborious	siêng năng
labyrinth	mê cung
lacerate	làm cho đau đớn
lackadaisical	làm bộ ỏng ẹo
lactation	cho con bú
lacteal	như sữa
lactic	lactic
laddie	thanh niên
ladle	lò nồi
laggard	chậm chạp
landholder	chủ đất
landlord	địa chủ
landmark	phong cảnh
landscape	phong cảnh
languid	uể oải
languor	sự yếu đuối
lapse	trôi đi
lascivious	đa dâm
lassie	con gái nhỏ
latent	ngầm
latency	độ trễ
later	một lát sau
lateral	ở bên
latish	hơi trể
lattice	mạng
laud	Laud
laudable	đáng khen ngợi
laudation	sự tán dương
laudatory	khen ngợi
laundress	người thợ giặt quần áo
laureate	đầu đội vòng hoa
lave	tắm rửa
lawgiver	nhà lập pháp
lawmaker	nhà làm luật
lax	không nghiêm
laxative	thuốc nhuận tràng
lea	đồng cỏ
leaflet	tờ rơi
leaven	căn nguyên
leeward	dưới gió
left-handed	thuận tay trái
legacy	di sản
legalize	làm cho hợp lệ
legging	legging
legible	rỏ ràng
legionary	thuộc về quân đoàn
legislate	lập pháp
legislative	lập pháp
legislator	nhà lập pháp
legitimacy	hợp pháp
legitimate	hợp pháp
leisure	giải trí
leniency	khoan dung
lenient	nhân hậu
leonine	thuộc về sư tử
lethargy	trạng thái hôn mê
levee	sự thức dậy
lever	đòn bẩy
leviathan	thủy quái khổng lồ
levity	không đứng đắn
levy	tiền
lewd	dâm dục
lexicographer	người nghiên cứu từ ngữ học
lexicography	ngữ học
lexicon	từ điển
liable	chịu trách nhiệm
libel	phỉ báng
liberalism	chủ nghĩa tự do
liberate	phóng thích
licentious	trụy lạc
licit	hợp pháp
liege	thần dân
lien	lien
lieu	thay vì
lifelike	giống như thật
lifelong	suốt đời
lifetime	cả đời
ligament	dây chằng
ligature	buộc
light-hearted	nhẹ dạ cả tin
ligneous	gổ
likelihood	khả năng
likely	rất có thể
liking	theo ý thích
limitation	sự hạn chế
linear	tuyến tính
liner	lót
lingo	tiếng lóng
lingua	ngữ
lingual	ngôn ngữ
linguist	ngôn ngữ học
linguistics	ngôn ngữ học
liniment	dầu xoa bóp
liquefacient	liquefacient
liquefy	Liquefy
liqueur	rượu mùi
liquidate	thanh lý
liquor	rượu
listless	thờ ơ
literacy	trình độ học vấn
literal	chữ
literature	văn chương
lithe	mềm mõng
lithesome	mềm
lithograph	in thạch bản
lithotype	lithotype
litigant	đương sự
litigate	kiện
litigious	tranh tụng
littoral	ở bờ biển
liturgy	phụng vụ
livelihood	kế sinh nhai
livid	xanh mét
loam	trét bằng đất sét
loath	không thích
loathe	không ưa
locative	thuộc về trường sở
loch	hồ
locomotion	sự vận động
lode	mạch mỏ
lodgment	ký thhác tiền bạc
logic	Hợp lý
logical	hợp lý
logician	nhà luận lý học
loiterer	người đi lang thang
loneliness	sự cô đơn
longevity	trường thọ
loot	đồ vật cướp được
loquacious	lắm lời
lordling	lordling
lough	cái hồ
louse	con rận
lovable	đáng yêu
low-spirited	buồn rầu
lowly	hèn mọn
lucid	sáng suốt
lucrative	có lợi
ludicrous	khôi hài
luminary	vật sáng chói
luminescent	phát quang
luminescence	phát quang
luminosity	tính phát quang
luminous	chói lọi
lunacy	hành động điên rồ
lunar	mặt trăng
lunatic	thuộc về người điên
lune	lune
lurid	trắng bệch
luscious	ngon
lustrous	bóng
luxuriance	sự tươi tốt
luxuriant	xum xê
luxuriate	sống trong cảnh xa hoa
lying	nói dối
lyre	thất huyền cầm
lyric	lời bài hát
macadamize	đắp nhiều lớp đá
machinery	máy móc thiết bị
machinist	thợ máy
macrocosm	vũ trụ bao la
madden	làm mất trí
Madonna	tranh của thánh mẫu
magician	nhà ảo thuật
magisterial	hống hách
magistracy	quan tòa
magnanimous	rộng lượng
magnate	đại thần
magnet	nam châm
magnetize	từ hóa
magnificence	sự lộng lẫy
magnificent	tráng lệ
magnitude	độ lớn
maharaja	Maharaja
maidenhood	cảnh độc thân
maintain	duy trì
maintenance	bảo trì
maize	bắp
makeup	trang điểm
malady	sự đau
malaria	bệnh sốt rét
malcontent	không bằng lòng
malediction	lời rủa
malefactor	người làm điều ác
maleficent	hiểm ác
malevolence	ác tâm
malevolent	xấu bụng
malign	hung tinh
malignant	ác tính
malleable	tánh dể sai khiến
mallet	vồ bằng cây
maltreat	hành hạ
man-trap	do con người bẫy
mandate	thi hành
mandatory	bắt buộc
mane	lông gáy
man-eater	người đàn ông ăn
maneuver	dùng mưu kế
mania	hưng
maniac	người khùng
manifesto	tuyên ngôn
manlike	tánh chất đàn ông
manliness	sự nam tính
mannerism	không tự nhiên
manor	lãnh địa
mantel	bệ trên lò sưởi
mantle	choàng
manufacturer	nhà chế tạo
manumission	sự phóng thích
manumit	phóng thích
marine	ở biển
maritime	hàng hải
maroon	Bỏ rơi
martial	võ
Martian	Hỏa
martyrdom	tử đạo
marvel	kỳ quan
masonry	nề
masquerade	giả mạo
massacre	tàn sát
massive	to lớn
masterpiece	kiệt tác
mastery	làm chủ
material	vật chất
materialize	cụ thể hoá
maternal	mẹ
matinee	buổi sáng
matricide	người giết mẹ
matrimony	hôn nhân
matrix	ma trận
matter	vấn đề
maudlin	hay khóc
mausoleum	lăng mộ
mawkish	lạt lẻo
maxim	châm ngôn
maze	mê cung
mead	đồng cỏ
meager	sơ sài
mealy-mouthed	ăn nói ngọt ngào
meander	quanh co
mechanics	cơ học
medallion	huy chương lớn
meddlesome	hay xen vào việc của người khác
medial	trung gian
mediate	trung gian
medicine	thuốc
medieval	trung cổ
mediocre	tầm thường
meditation	thiền
medley	trộn lộn
meliorate	sửa cho tốt
mellifluous	ngọt ngào
melodious	du dương
melodrama	nhạc kịch xưa
memento	kinh ký niệm
memorable	đáng ghi nhớ
menace	đe dọa
menagerie	thú trong chuồng của gánh hát xiệc
mendacious	nói láo
mendicant	sự ăn xin
mentality	tâm trạng
mentor	người hướng dẫn
mercantile	con buôn
mercenary	lính đánh thuê
merciful	từ bi
merciless	tàn nhẫn
meretricious	hào nháng
mesmerize	thôi miên
messieurs	messieurs
metal	kim loại
metallurgy	luyện kim
metamorphosis	sự biến hình
metaphor	ẩn dụ
metaphysical	siêu hình
metaphysician	người chuyên về siêu hình học
metaphysics	hình nhi thượng học
mete	đo
metempsychosis	thuyết luân hồi
meticulous	tỉ mỉ
metonymy	phép hoán dụ
metric	Hệ mét
metronome	máy nhịp
metropolis	thủ đô
metropolitan	đô thị
mettle	dũng khí
mettlesome	hăng hái
microcosm	ống kính hiển vi
micrometer	thước trắc vi
microphone	cái mic cờ rô
microscope	kính hiển vi
microscopic	vi
microscopy	kính hiển vi
midsummer	khoảng giữa mùa hè
midwife	nữ hộ sinh
mien	mien
migrant	nhập cư
migrate	di cư
migratory	di trú
mileage	dặm
militant	chiến đấu
militarism	chũ nghĩa quân phiệt
militate	làm chứng
militia	lực lượng dân vệ
Milky	thuộc về sữa
millet	cây kê
mimic	bắt chước
miniature	thu nhỏ
minimize	hạn chế tối đa
minion	thương yêu
ministration	sự chăm nom
ministry	Bộ
minority	thiểu số
minute	phút
minutia	minutia
mirage	ảo ảnh
misadventure	việc rủi ro
misanthropic	hận người
misanthropy	tánh ghét đời
misapprehend	hiểu lầm
misbehave	cư xừ không đứng đắng
misbehavior	phẩm hạnh không tốt
mischievous	tinh nghịch
miscount	tính sai
miscreant	hư
misdeed	hành động xấu
misdemeanor	điều lăng nhục
miser	người bủn xỉn
mishap	sự rủi ro
misinterpret	giải thích sai
mislay	làm lạc mất
mismanage	giám đốc dở
misnomer	sự lộn tên
misogamy	sự ghét kết hôn
misogyny	tánh ghét đàn bà
misplace	để lộn chổ
misrepresent	trình bày không đúng
misrule	vô tổ chức
missal	sách lể
missile	hỏa tiễn
missive	thơ chánh thức
mistrust	ngờ vực
misty	mơ hồ
misunderstand	hiểu sai
misuse	lạm dụng
mite	đứa bé
miter	mũ của giám mục
mitigate	Giảm thiểu
mnemonics	thuật ký ức
moat	hào sâu
mobocracy	mobocracy
moccasin	giày làm bằng da nai
mockery	sự nhạo báng
moderation	sự tiết chế
moderator	người điều hành
modernity	hiện đại
modernize	hiện đại hóa
modification	sự sửa đổi
modify	Sửa
modish	hợp thời trang
modulate	ngâm nga
mollify	làm người nào nguôi
molt	thay lông
momentary	tạm thời
momentous	quan trọng
momentum	Quán tính
monarchy	chế độ quân chủ
monastery	tu viện
monetary	tiền tệ
mongrel	thú lai
monition	lời rao
monitory	lời giáo huấn
monocracy	monocracy
monogamy	chế độ một vợ
monogram	hai hoặc nhiều chữ kết lại thành một
monograph	chuyên khảo
monolith	bia làm bằng nguyên một khối đá
monologue	độc thoại
monomania	chứng chấp cuồng
monopoly	sự độc quyền
monosyllable	tiếng đơn âm
monotone	giọng bằng bằng
monotonous	đơn điệu
monotony	sự không thay đổi
monsieur	Ngài
monstrosity	kỳ quái
moonbeam	tia sáng trăng
morale	đạo đức
moralist	nhà đạo đức học
morality	đạo đức
moralize	nói về luân lý
moratorium	lệnh cấm
morbid	thuộc về bịnh
mordacious	mordacious
mordant	thuốc ăn màu
moribund	hấp hối
morose	buồn rầu
morphology	hình thái học
motley	các màu khác nhau
motto	châm ngôn
mountaineer	dân miền núi
mountainous	miền núi
mouthful	một họng
muddle	làm lộn xộn
muffle	múp
mulatto	nước da ngâm mgâm
muleteer	người dắt la
multiform	có nhiều hình trạng
multiplicity	số nhiều
mundane	trần tục
municipal	thành phố
municipality	thành phố
munificence	lòng khoan hồng
munificent	khoan hồng
muster	Tập hợp
mutation	sự thay đổi
mutilate	làm hư hỏng
mutiny	nổi loạn
myriad	vô số
mystic	huyền bí
mystification	sự bao trùm bí mật
myth	chuyện thần thoại
mythology	chuyện thần thoại
nameless	không tên
naphtha	dầu hỏa
Narcissus	cây thủy tiên
narrate	Narrate
narration	sự thuật lại
narrative	tường thuật
narrator	người dẫn chuyện
narrow-minded	trí đần độn
nasal	mũi
natal	natal
nationality	Quốc tịch
naturally	một cách tự nhiên
nausea	buồn nôn
nauseate	gớm
nauseous	làm nôn mửa
nautical	hải lý
naval	hải quân
navel	lỗ rốn
navigable	điều hướng
navigate	điều hướng
nebula	tinh vân
necessary	cần thiết
necessitate	bắt buộc
necessity	điều cần thiết
necrology	bộ tử
necromancer	thầy chiêu hồn
necropolis	mộ địa
necrosis	chứng hoại tử
nectar	rượu tiên
nectarine	cây xuân đào
needlework	công việc may vá
needy	người túng thiếu
nefarious	người nham hiểm
negate	phủ nhận
negation	sự phủ nhận
neglectful	bỏ bê
negligee	negligee
negligence	thiếu trách nhiệm
negligent	không lo
negligible	không đáng kể
negotiable	thương lượng
Nemesis	Nemesis
neocracy	neocracy
neo-Darwinsim	tân Darwinsim
neo-Latin	neo-Latin
neopaganism	neopaganism
Neolithic	thuộc về tân thạch khí thời đại
neology	dùng chữ mới
neophyte	tân đảng viên
nestle	chổ ẩn núp
nestling	chim con còn trong ổ
nettle	cây tầm ma
network	mạng
neural	thần kinh
neurology	thần kinh học
neuter	thiến
neutral	Trung tính
nevertheless	Tuy nhiên
Newtonian	thuyết học Newton
niggardly	bủn xỉn
nihilist	hư vô chủ nghĩa
nil	không
nimble	lanh lợi
nit	trứng chí
nocturnal	đêm
noiseless	không ồn ào
noisome	cây độc
noisy	ồn ào
nomad	nay đây mai đó
nomic	nomic
nominal	trên danh nghĩa
nominate	đề cử
nomination	sự đề cử
nominee	đề cử
non-existent	không tồn tại
non-resident	không thường trú
nonchalance	tánh lãnh đạm
non-combatant	người không tác chiến
nondescript	khó nhận
nonentity	trạng thái không có
nonpareil	vô song
norm	qui tắc
normalcy	tính chất thông thường
Norman	người Norman
nostrum	thuốc của lang băm
noticeable	đáng chú ý
notorious	khét tiếng
novellette	novellette
novice	chú tiểu
nowadays	ngày nay
nowhere	hư không
noxious	có hại
nuance	nuance
nucleus	nhân tế bào
nude	khỏa thân
nugatory	vô giá trị
nuisance	làm phiền
numeration	phép đếm
numerical	bằng số
nunnery	tu viện
nuptial	thuộc về hôn nhân
nurture	dưỡng dục
nutriment	đồ ăn bổ dưỡng
nutritive	chất dinh dưỡng
oaken	thuộc về cây sồi
oakum	xơ gai
obdurate	tánh ngoan cố
obelisk	cây giống hình tiêm bi
obese	Béo phì
obesity	béo phì
obituary	cáo phó
objective	mục tiêu
objector	người phản đối
obligate	bắt buộc
obligatory	bắt buộc
oblique	xiên
obliterate	bôi
oblivion	lãng quên
oblong	hình chữ nhựt
obnoxious	khó ưa
obsequies	đám tang
obsequious	khúm núm
observance	chấp hành
observant	quan sát
observatory	đài thiên văn
obsolescence	không dùng nữa
obsolescent	không dùng nữa
obsolete	lỗi thời
obstetrician	người đở sanh
obstetrics	sản khoa học
obstinacy	tánh ương ngạnh
obstreperous	huyên náo
obstruct	gây trở ngại
obstruction	cản trở
obtrude	ép
obtrusive	quấy rầy
obvert	obvert
obviate	phòng ngừa
occasion	dịp
Occident	phương tây
occlude	hút vào
occult	bí ẩn
occupant	người có việc làm
occurrence	tần suất xảy ra
octagon	hình tám góc
octave	đoạn thơ tám câu
octavo	octavo
octogenarian	già tám mươi tuổi
ocular	thuộc về mắt
oculist	thầy thuốc chữa bịnh mắt
oddity	vật kỳ quái
ode	bài thơ ngắn để hát
odious	đáng ghét
odium	chê bai
odoriferous	có mùi thơm
odorous	thơm
off	tắt
offhand	ngay
officiate	hành lể
officious	sốt sắng
offshoot	chồi cây
ogre	ông kẹ
ointment	thuốc mở
olfactory	khứu giác
olive-branch	Cành oliu
ominous	điềm xấu
omission	bỏ xót
omnipotence	sức vạn năng
Omnipotent	thượng đế
omniscience	toàn trí
omniscient	toàn trí
omnivorous	ăn tất cả mọi thứ
onerous	nặng
onrush	xông tới
onset	tấn công
onslaught	tấn công
onus	trách nhiệm
opalescence	opan
opaque	mờ mịt
operate	vận hành
operative	operative
operator	nhà điều hành
operetta	operetta
opinion	ý kiến
opponent	phản đối
opportune	hợp thời
opportunist	người cơ hội
opportunity	dịp tốt
opposite	đối diện
opprobrium	điều sĩ nhục
optic	thị giác
optician	người làm kiến ​​đeo mắt
optics	quang học
optimism	lạc quan
option	Lựa chọn
optometry	khúc xạ nhãn khoa
opulence	phong phú
opulent	phong phú
oral	miệng
orate	nói dai
oration	bài diển văn
orator	người diển thuyết
oratorio	tôn giáo nhạc kịch
oratory	tài hùng biện
ordeal	thử thách
ordinal	thứ tự
ordination	phối
ordnance	sở quân dụng
orgies	orgies
origin	gốc
original	nguyên
originate	bắt đầu
ornate	văn hoa
orthodox	chánh thống
orthodoxy	sự chánh thống
orthogonal	trực giao
orthopedic	chỉnh hình
orthopedist	chỉnh hình
oscillate	dao động
osculate	hôn nhau
ossify	thành chai
ostentation	phô trương
ostracism	sự lưu đày
ostracize	lưu đày
ought	phải
oust	trục xuất
out-and-out	ra-và-out
outbreak	sự bùng phát
outburst	sự bùng nổ
outcast	bỏ bơ vơ
outcry	phản đối
outdo	làm giỏi hơn
outlandish	lạ lùng
outlast	lâu hơn
outlaw	ngoài vòng pháp luật
outlive	còn sống
out-of-the-way	ở xa
outpost	tiền đồn
outrage	xúc phạm
outrageous	tàn nhẫn
outreach	tiếp cận cộng đồng
outride	cởi ngựa mau hơn
outrigger	Outrigger
outright	ngay
outskirt	ngoại ô
outstretch	outstretch
outstrip	vượt qua
outweigh	lớn hơn
overdo	làm quá sức
overdose	quá liều
overeat	ăn quá độ
overhang	phần lồi ra
overleap	nhảy qua
overlord	bá Vương
overpass	đi ngang qua
overpay	trả nhiều quá
overpower	Overpower
overproduction	sản xuất nhiều quá
overreach	sự đánh lừa
overrun	tràn ngập
oversee	trông nom
overseer	người giám thị
overshadow	che lấp
overstride	overstride
overthrow	lật đổ
overtone	họa âm
overture	sự bắt đầu
overweight	thừa cân
pacify	hòa bình
packet	gói
pact	hiệp ước
pagan	ngoại đạo
pageant	cảnh lịch sử
palate	khẩu cái
palatial	nguy nga
paleontology	cổ sinh vật học
palette	bảng
palinode	sự cải chính
pall	vô vị
palliate	làm dịu bớt
pallid	xanh nhợt
palpable	rỏ ràng
palsy	tình trạng vô hiệu
paly	phai màu
pamphlet	cuốn sách nhỏ
pamphleteer	người viết bài luận ngắn
panacea	thuốc trị bá bịnh
Pan-American	Thuộc về người Mỹ gốc Panama
pandemic	đại dịch
pandemonium	chổ lộn xộn
panegyric	lời khen
panel	bảng điều khiển
panic	hoảng loạn
panoply	đồ vỏ trang
panorama	panorama
pantheism	phiếm thần luận
Pantheon	đền
pantomime	kịch câm
pantoscope	pantoscope
papacy	chức vị giáo hoàng
papyrus	cây chỉ thảo
parable	ngụ ngôn
paradox	nghịch lý
paragon	hột kim cương
parallel	song song, tương đông
parallelism	xử lý song song
paralysis	tê liệt
paralyze	tê liệt
paramount	tối quan trọng
paramour	tình nhân
paraphernalia	tài sản cá nhân
paraphrase	diễn giải
pare	bóc vỏ
parentage	tư cách bà con
Pariah	pariah
parish	giáo khu
Parisian	dân Ba lê
parity	Ngang bằng
parlance	cách nói
parley	đàm phán
parliament	nghị viện
parlor	phòng khách
parody	Chế
paronymous	paronymous
paroxysm	cực điểm
parricide	tội giết cha mẹ
parse	phân tích cú pháp
parsimonious	bủn xỉn
partible	thiên vị
participant	người tham gia
participate	tham dự
partition	vách ngăn
partisan	thân binh
passible	passible
passive	thụ động
pastoral	mục vụ
paternal	nội
paternity	tư cách làm cha
pathos	sự nói cảm động
patriarch	tộc trưởng
patrician	quí tộc
patrimony	di sản
patriotism	lòng ái quốc
patronize	bảo trợ
patronymic	thuộc về họ trong gia đình
patter	nói trôi chảy
paucity	số tối thiểu
pauper	người bần cùng
pauperism	tình trạng bần cùng
pavilion	lều
payee	người thụ hưởng
peaceable	có thể thái bình
peaceful	bình yên
peccable	dể lầm lổi
peccadillo	lổi nhẹ
peccant	có lổi
pectoral	tấm giáp che ngực
pecuniary	thuộc về tiền bạc
pedagogics	giáo dục học
pedagogue	giáo sư
pedagogy	sư phạm
pedal	bàn đạp
pedant	nhà giáo
peddle	Peddle
pedestal	bệ đỡ
pedestrian	người đi bộ
pediatrics	sự kê gian
pedigree	tiền nhân
peddler	người bán rong
peerage	đẳng cấp
peerless	không ai bằng
peevish	gắt gỏng
pellucid	trong suốt
penalty	hình phạt
penance	gia tội
penchant	thiên hướng
pendant	mặt dây chuyền
pendulous	lung lay
pendulum	quả lắc đồng hồ
penetrable	có thấm vào
penetrate	xâm nhập
penetration	thâm nhập
peninsular	dân ở bán đảo
penitence	sự ăn năn
penitential	thuộc về ăn năn
pennant	cờ hiệu
pension	tiền cấp dưỡng
pentagram	Pentagram
pentavalent	pentavalent
pentad	thời gian năm năm
pentagon	Hình năm góc
pentahedron	hình khối năm mặt
pentameter	câu thơ năm chữ
pentathlon	năm thứ thể thao ở hy lạp
penultimate	trước vần chót
penurious	không màu mở
penury	cảnh cơ hàn
perambulate	đi thanh tra
perceive	Nhận thức
perceptible	có thể nhận ra
perception	sự nhận thức
percipience	percipience
percipient	tri giác
percolate	thấm qua
percolator	cái đồ lọc nước
percussion	bộ gõ
peremptory	quả quyết
perennial	vĩnh cửu
perfectible	có thể làm xong
perfidy	sự bội tín
perforate	khoan lổ
perform	biểu diễn
perfumery	nước hoa
perfunctory	làm cho có lệ
perhaps	có lẽ
perigee	điểm cận địa
periodicity	tính tuần hoàn
peripatetic	người bán rong
perjure	perjure
perjury	trái với lời thề
permanence	sự có luôn luôn
permanent	dài hạn
permeate	thấm nhập
permissible	có thể chấp nhận
permutation	sự hoán vị
pernicious	nguy hiểm
perpendicular	thẳng góc
perpetrator	người phạm tội
perpetuate	làm cho lâu dài
perquisite	lợi bất kỳ
persecution	áp bức
perseverance	kiên trì
persevere	bền lòng
persiflage	lời nhạo báng
persist	kiên gan
persistence	kiên trì
personage	nhân vật
personal	cá nhân
personality	nhân cách
personnel	nhân viên
perspective	Góc nhìn cá nhân
perspicacious	sáng suốt
perspicacity	sự thông minh
perspicuous	dể hiểu
perspiration	sự đổ mồ hôi
perspire	ra mồ hôi
persuade	truy vấn
persuadable	có thể tin
pertinacious	bướng bỉnh
pertinacity	tánh cứng đầu
pertinent	thích hợp
perturb	gây sự
perturbation	sự bối rối
perusal	sự chăm chú
pervade	ngấm vào
pervasion	sự xâm nhập
pervasive	tràn lan
perverse	ngoan cố
perversion	sự lạc đường
perversity	sự cau có
pervert	kẻ biến thái
pervious	dể qua
pestilence	bịnh dịch hạch
pestilent	hại
pestilential	thuộc về bịnh dịch hạch
peter	peter
petrify	Petrify
petulance	tánh nóng nảy
petulant	nóng nảy
pharmacopoeia	số thuốc dự trữ
pharmacy	tiệm thuốc
phenomenal	hiện tượng
phenomenon	hiện tượng
philander	tan gai
philanthropic	từ thiện
philanthropist	từ thiện
philanthropy	lòng thương người
philately	sự sưu tầm tem thơ
philharmonic	thích âm nhạc
philogynist	philogynist
philologist	nhà ngôn ngữ học
philology	ngôn ngữ học
philosophize	bàn luận
philosophy	triết học
phlegmatic	Lãnh đạm
phonetic	ngữ âm
phonic	thuộc về ngữ âm
phonogram	bản ghi âm
phonology	phát âm học
phosphorescence	lân
photoelectric	quang điện
photometer	quang kế
photometry	phép trắc quang
physicist	nhà vật lý học
physics	vật lý
physiocracy	Chủ nghĩa trọng nông
physiognomy	thuật xem tướng mạo
physiography	physiography
physiology	sinh lý học
physique	thể chất
picayune	Picayune
piccolo	ống sáo nhỏ
piece	cái
piecemeal	từng miếng
pillage	cướp bóc
pillory	bêu xấu
pincers	kìm
pinchers	kìm kẹp
pinnacle	đỉnh núi
pioneer	tiên phong
pious	sùng đạo
pique	khiêu gợi
piteous	đáng thương hại
pitiable	đáng thương hại
pitiful	thương tâm
pitiless	không đáng thương
pittance	tiền công rất ít
placate	điều đình
placid	yên lặng
plagiarism	đạo văn
planisphere	bình đồ địa
plasticity	tính nắn được
platitude	tính cách tầm thường
plaudit	một tràng vổ tay
plausible	có vẻ hợp lý
playful	vui tươi
playwright	nhà viết kịch
plea	sự biện hộ
pleasant	hài lòng
pleasurable	vui vẻ
plebeian	thuộc về hạng bình dân
pledgee	người nhận cầm đồ
pledgeor	pledgeor
plenary	toàn thể
plenipotentiary	được chủ quyền
plenitude	sự phong phú
plenteous	mầu mở
plumb	thẳng
plummet	dây chì
pluperfect	đại quá khứ
plural	số nhiều
plurality	đa số
plutocracy	chế độ tài phiệt
pneumatic	khí nén
poesy	poesy
poetaster	thi sĩ xoàng
poetic	thơ
poetics	thơ
poignancy	sự cay
poignant	chua cay
poise	sự cân nhau
polar	cực
polemics	sự tranh luận
pollen	phấn hoa
pollute	ô nhiễm
polyarchy	polyarchy
polycracy	polycracy
polygamy	tình trạng nhiều vợ hoặc chồng
polyglot	có nhiều thứ tiếng
polygon	đa giác
polyhedron	khối có nhiều mặt
polysyllable	chữ nhiều âm
polytechnic	thuộc về bách nghệ
polytheism	tôn sùng nhiều thần thánh
pommel	đốc gươm
pomposity	sự tự phụ
pompous	kiêu ngạo
ponder	suy ngẫm
ponderous	nặng
pontiff	giáo hoàng
populace	quần chúng
populous	đông dân
portend	báo trước
portent	điềm xấu
portfolio	danh mục đầu tư
posit	thỉnh cầu
position	Chức vụ
positive	tích cực
posse	đội cảnh sát
possess	có
possession	chiếm hữu
possessive	trường hợp chiếm hửu
possessor	người sở hửu
possible	khả thi
postdate	Ngay gưỉ
posterior	sau
postgraduate	sau đại học
postscript	tái bút
potency	mạnh
potent	mạnh
potentate	vua chuyên chế
potential	tiềm năng
potion	potion
powerless	bất lực
practicable	có thể thực hiện
prate	làm mất thì giờ
prattle	nói lảm nhảm
preamble	lời nói đầu
precarious	bấp bênh
precaution	sự đề phòng
precede	đứng trước
precedence	quyền ưu tiên
precedent	tiền lệ
precedential	cho bất kì
precession	sự đi trước
precipice	vách dựng ngược
precipitant	chất kết tủa
precipitate	kết tủa
precise	tóm lược
precision	độ chính xác
preclude	phòng ngừa
precocious	thông minh sớm
precursor	tiền thân
predatory	cướp bóc
predecessor	người tiền nhiệm
predicament	khó khăn
predicate	Thuộc tính
predict	dự đoán
prediction	sự dự đoán
predominance	địa vị cao hơn
predominant	cao hơn
predominate	chiếm ưu thế
preeminence	sự hoàn toàn
preempt	preempt
preemption	sự mua trước
preengage	preengage
preestablish	preestablish
preexist	preexist
preexistence	hiện hữu từ trước
preface	lời nói đầu
prefatory	mở đầu
prefer	thích hơn
preferable	thích hợp hơn
preference	sự ưa thích
preferential	ưu đãi
preferment	preferment
prefix	tiếp đầu ngữ
prehensible	prehensible
prehensile	có năng lực cầm
prehension	sự nắm được
prejudice	định kiến
prelacy	chức giám mục
prelate	giám mục
prelude	khúc dạo đầu
premature	sớm
premier	Thủ tướng
premise	tiên đề
premonition	điều báo trước
preoccupation	sự lo lắng
preoccupy	chiếm trước
preordain	preordain
preparation	sự chuẩn bị
preparatory	chuẩn bị
preponderant	nặng hơn
preponderate	cân nặng hơn
prepossession	sự dự kiến
preposterous	phi lý
prerogative	đặc quyền
presage	chỉ điềm
prescience	sự thấy trước
prescient	thấy trước
prescript	mạng lịnh
prescriptible	prescriptible
prescription	đơn thuốc
presentient	presentient
presentiment	điềm
presentment	cuộc diển kịch
preservation	sự bảo tồn
presumption	giả định
presumptuous	xấc láo
pretension	kỳ vọng
pretentious	tự phụ
preternatural	preternatural
pretext	cớ
prevalence	tỷ lệ
prevalent	đang thịnh hành
prevaricate	Nói quanh co
prevention	Phòng ngừa
prickle	cảm giác bị châm
priggish	làm bộ
prim	nghiêm trang
prima	prima
primer	lót
primeval	nguyên sinh
primitive	nguyên thủy
principal	hiệu trưởng
principality	chức vương
principle	nguyên tắc
priory	Tu viện
pristine	nguyên sơ
privateer	tàu của tư nhân
privilege	đặc quyền
privity	sự hiểu biết riêng
privy	riêng
probate	sự kiểm nhận
probation	kiểm soát
probe	thăm dò
probity	thành thật
procedure	phương pháp
proceed	tiến hành
proclamation	công bố
procrastinate	hoản lại
procrastination	sự trì hoãn
proctor	người đại lý
prodigal	hoang phí
prodigious	phi thường
prodigy	người phi thường
productive	sản xuất
profession	nghề nghiệp
professor	Giáo sư
proffer	sự dâng
proficiency	khả năng
proficient	giỏi
profile	Hồ sơ
profiteer	người đầu cơ
profligacy	sự trác táng
profligate	trác táng
profuse	xài phí
progeny	con cháu
progression	sự phát triển
prohibition	cấm
prohibitionist	người tán thành sự cấm chế
prohibitory	cấm chỉ
projection	chiếu
proletarian	thuộc về dân lao động
prolific	phong phú
prolix	rườm rà
prologue	lời nói đầu
prolong	kéo dài thời gian
promenade	đi chơi
prominence	nổi bật
prominent	đáng chú ý
promiscuous	lộn xộn
promissory	tuyên thệ
promontory	mũi đất nhô ra
promoter	người ủng hộ
promulgate	Ban hành
propaganda	công tác tuyên truyền
propagate	Tuyên truyền
propel	propel
propellant	đẩy
propeller	cánh quạt
prophecy	lời tiên tri
prophesy	tiên tri
propitious	thuận tiện
proportionate	theo tỷ lệ
propriety	sự đúng nghi thức
propulsion	sự đẩy tới
prosaic	thuộc về văn xuôi
proscenium	phần trước sân khấu
proscribe	cấm
proscription	sự bài xích
proselyte	người mới nhập hội
prosody	thi học
prospector	người đi tìm vàng
prospectus	Bản cáo bạch
prostrate	phủ phục
protagonist	trưởng đoàn
protection	sự bảo vệ
protective	bảo vệ
protector	người bảo vệ
protege	bảo trợ
Protestant	Tin Lành
protomartyr	protomartyr
protocol	Nghị định thư
protoplasm	nguyên sinh vật
prototype	nguyên mẫu
protract	kéo dài
protrude	Nhô ra
protrusion	sự đẩy tới trước
protuberance	chổ nhô lên
protuberant	lồi lên
protuberate	protuberate
proverb	tục ngữ
provident	tiết kiệm
providential	do thiên ý
provincial	tỉnh
proviso	điều khoản
provocation	khiêu khích
prowess	sức mạnh
proximately	xấp xỉ
proxy	Ủy quyền
prudence	sự khôn ngoan
prudential	bảo đảm an toàn
prudery	sự giừ gìn
prurient	dâm ô
pseudapostle	pseudapostle
pseudonym	tên giả
pseudonymity	pseudonymity
psychiatry	tinh thần bịnh học
psychic	nhà ngoại cảm
psychopathic	thuộc về bịnh thần kinh
psychotherapy	tâm lý
pudgy	béo lùn
puerile	thuộc về trẻ con
pugnacious	hay cải
puissant	có sức mạnh
pulmonary	phổi
punctilious	quá câu nệ
punctual	đúng giờ
pungent	khó chịu
pungency	tính chua chát
punitive	để trừng phạt
pupilage	thời kỳ học sinh
purgatory	để luyện tội
purl	kim tuyến
purloin	lấy trộm
purport	bài diển văn
purveyor	người thầu cung cấp
pusillanimous	khiếp nhược
putrescent	putrescent
pyre	giàn hỏa
pyromania	chứng điên hay đốt nhà
pyrotechnic	thuộc về thuật hỏa công
pyx	bình đựng thánh thể
quackery	thủ đoạn
quadrate	vuông
quadruple	tứ bội
qualification	trình độ chuyên môn
qualify	đủ điều kiện
qualm	sự lo âu
quandary	nỗi khó khăn
quantity	định lượng
quarantine	cách ly
quarrelsome	hay giận
quarter	phần tư
quarterly	hàng quý
quartet	tứ
quarto	khổ giấy in gấp làm bốn
quay	bến tàu
querulous	hay than van
query	truy vấn
queue	xếp hàng
quibble	không phân minh
quiescence	sự yên lặng
quiescent	yên
quiet	Yên tĩnh
quietus	bắn cho chết hẳn
quintessence	đệ ngũ nguyên tố
quintet	khúc nhạc năm phần
quite	khá
Quixotic	anh hùng rơm
rabid	quá sốt sắng
racy	đầy nhiệt huyết
radiance	ánh sáng chói lọi
radiate	phát xạ
radical	căn bản
radix	cơ số lô ga rít
raillery	lời giểu cợt
ramify	phân nhánh
ramose	có nhiều nhánh
rampant	hung hăng
rampart	thành lủy
rancor	sự thù hận
rankle	vết thương làm độc
rapacious	tham lam
rapid	nhanh
rapine	sự ăn cướp
rapt	khoái trá
raptorial	tham lam
ration	khẩu phần
rationalism	lý luận học
raucous	hơi thở khò khè
ravage	tàn phá
ravenous	ăn mồi
ravine	khe suối
reaction	sự phản ứng
reactionary	phản động
readily	dễ dàng
readjust	chỉnh lý
ready	Sẵn sàng
realism	chủ nghĩa hiện thực
rearrange	sắp xếp lại
reassure	Trấn an
rebellious	ương ngạnh
rebuff	từ chối
rebuild	xây dựng lại
rebut	bác bỏ
recant	chối
recapitulate	tóm lại
recapture	chiếm lại
recede	rút đi
receivable	thu
receptive	tiếp thu
recessive	Lặn
recidivist	người tại phạm
reciprocal	đối ứng
reciprocate	xoay chiều
reciprocity	sự tương phản
recitation	ngâm thơ
reck	reck
reckless	liều lĩnh
reclaim	đòi lại
recline	đặt vào vật gì
recluse	ẩn dật
reclusory	reclusory
recognizance	sự tuân theo điều kiện của tòa án
recognize	nhìn nhận
recoil	bật lên
recollect	nhớ lại
reconcilable	có thể điều hòa
reconnoiter	người dò xét
reconsider	xem xét lại
reconstruct	tái tạo lại
recourse	sự trông cậy
recover	bình phục
recreant	phản đảng
recreate	tái tạo
recrudescence	sự tái diển
recrudescent	recrudescent
recruit	tuyển dụng
rectify	chỉnh lưu
rectitude	sự đứng đắn
recuperate	hồi phục
recur	tái xuất
recure	recure
recurrent	định kỳ
redemption	chuộc lỗi
redolent	có hương thơm
redolence	mùi thơm
redoubtable	ghê ghớm
redound	chịu phần
redress	kiểu chính
reducible	có thể giãm giá
redundance	sự rờm rà
redundant	dư thừa
reestablish	thiết lập lại
refer	tham khảo
referrer	giới thiệu
referable	referable
referee	trọng tài
refinery	xưởng lọc dầu
reflectible	reflectible
reflection	sự phản xạ
reflector	gương phản chiếu
reflexible	reflexible
reform	cải cách
reformer	nhà cải cách
refract	khúc xạ
refractory	dai dẳng
refragable	refragable
refringency	refringency
refringent	refringent
refusal	sự từ chối
refute	bác bỏ
regale	Regale
regalia	biểu chương của vua
regality	quyền hành của vua
regenerate	tái tạo
regent	hội đồng quản trị
regicide	người giết vua
regime	chế độ
regimen	phác đồ điều trị
regiment	trung đoàn
regnant	tại ngôi
regress	thoái
regretful	ân hận
rehabilitate	phục hồi
reign	triều đại
reimburse	trả lại
rein	kiềm chế
reinstate	phục chức
reiterate	nhắc lại
rejoin	tái tham gia
rejuvenate	Rejuvenate
rejuvenescence	sự làm trẻ lại
relapse	tái phạm
relegate	đổi đi xa
relent	nên dịu dàng
relevant	liên quan, thích hợp
reliance	sự tín nhiệm
reliant	tín nhiệm
relinquish	từ chức
reliquary	hòm
relish	nếm
reluctance	miễn cưỡng
reluctant	lưỡng lự
remembrance	hồi tưởng
reminiscence	sự nhớ lại
reminiscent	làm nhớ lại
remiss	nhu nhược
remission	thuyên giảm
remodel	sửa kiểu lại
remonstrance	sự khiển trách
remonstrant	khiển trách
remonstrate	khiển trách
remunerate	tặng thưởng
remuneration	thù lao
Renaissance	sự phục hưng
rendezvous	nơi hẹn
rendition	sự thông dịch
renovate	Đổi mới
renunciation	từ bỏ
reorganize	tái tổ chức
reparable	bồi thường được
reparation	sự phân phối
repartee	lời đáp lại
repeal	thủ tiêu
repel	Repel
repellent	không thấm
repentance	ăn năn
repertory	kho tàng
repetition	sự lập lại
repine	phàn nàn
replenish	Replenish
replete	đầy
replica	bản sao
repository	kho
reprehend	khiển trách
reprehensible	khiển trách
reprehension	sự khiển trách
repress	đàn áp
repressible	repressible
reprieve	đặc xá trạng
reprimand	khiển trách
reprisal	sự trả thù
reprobate	chê
reproduce	tái sản xuất
reproduction	sinh sản
reproof	lời quở trách
repudiate	từ bỏ
repugnance	tính không hợp nhau
repugnant	không hợp
repulse	sự từ chối
repulsive	ghét
repute	thanh danh
requiem	cầu siêu
requisite	điều kiện cần thiết
requital	sự tưởng thưởng
requite	bù lại
rescind	hủy bỏ
reseat	trở lại ghế ngồi
resemblance	sự giống nhau
resent	gửi lại
reservoir	Hồ chứa
residue	phần còn lại
resilience	khả năng phục hồi
resilient	đàn hồi
resistance	Sức cản
resistant	chống lại
resistive	điện trở
resistless	không đề kháng
resonance	cộng hưởng
resonate	cộng hưởng
resource	nguồn
respite	thời gian nghỉ ngơi
resplendent	chói lọi
respondent	người trả lời
restitution	bồi thường
resumption	sự trở lại
resurgent	nổi lên
resurrection	phục sinh
resuscitate	làm cho sống lại
retaliate	trả thù
retch	sự buồn nôn
retention	giữ lại
reticence	tánh thận trọng
reticent	kín đáo
retinue	đoàn tùy tùng
retort	đáp lại
retouch	sự sửa lại
retrace	retrace
retract	-co
retrench	giãm bớt
retrieve	lấy lại
retroactive	hồi tố
retrograde	thoái hóa
retrogression	sự đi ngược lại
retrospect	Nhìn lại
retrospective	quá khứ
reunite	gặp lại nhau
revelation	sự tiết lộ
revere	tôn kính
reverent	tôn kính
reversion	sự trở lại
revert	Hoàn nguyên
revile	chưởi rủa
revisal	revisal
revise	xem lại
revocation	thu hồi
revoke	Thu hồi
rhapsody	sử thi ca
rhetoric	Hùng biện
rhetorician	nhà tu từ học
ribald	người thô lỗ
riddance	sự tự do
ridicule	nhạo báng
ridiculous	nực cười
rife	hoành hành
righteousness	công bình
rightful	hợp pháp
rigmarole	sự nói huyên thuyên
rigor	tính chính xác
rigorous	nghiêm ngặt
ripplet	ripplet
risible	dể tức cười
rivulet	con lạch
robust	mạnh
rondo	bản nhạc ngắn
rookery	xóm nhà lụp xụp
rotary	quay
rotate	quay
rote	sự học thuộc lòng
rotund	tròn
rudimentary	thô sơ
rue	sự hối hận
ruffian	người du côn
ruminant	hay nghĩ ngợi
ruminate	nhại lại
rupture	đoạn tuyệt
rustic	mộc mạc
ruth	lòng trắc ẩn
sacrifice	sự hy sinh
sacrificial	hy sinh
sacrilege	sự phạm tội
sacrilegious	phạm thánh
safeguard	bảo vệ
sagacious	khôn ngoan
salacious	dâm ô
salience	chổ nhô ra
salient	Quan trọng
saline	nước muối
salutary	bổ ích
salutation	sự chào
salutatory	nhập đề
salvage	cứu hộ
salvo	phương pháp cứu người
sanctimonious	tín ngưởng
sanction	phê chuẩn
sanctity	thánh
sanguinary	dã man
sanguine	lạc quan
sanguineous	có nhiều máu
sapid	có hương vị
sapience	sự khôn ngoan
sapient	khôn
sapiential	trí thư
saponaceous	có chất xà bông
sarcasm	mỉa mai
sarcophagus	loại ruồi thịt
sardonic	chua chát
satiate	ăn cho no
satire	lời châm biếm
satiric	chế nhạo
satirize	châm biếm
satyr	người dâm dục
savage	dã man
savor	hương thơm
scabbard	bao kiếm
scarcity	sự khan hiếm
scholarly	uyên bác
scholastic	niên học
scintilla	Scintilla
scintillate	long lanh
scope	phạm vi
scoundrel	đứa vô lại
scribble	chỉ viết cẩu thả
scribe	người sao lại
script	kịch bản
Scriptural	thánh kinh
scruple	đơn vị trọng lượng
scrupulous	chu đáo
scurrilous	hèn hạ
scuttle	làm đắm
scythe	lưỡi hái
seance	lên đồng
sear	áp chảo
sebaceous	có tính chất mỡ
secant	đương căt
secede	phân ly
secession	sự phân ly
seclude	nhốt chim
seclusion	bế quan tỏa cảng
secondary	thứ hai
secondly	thứ hai
second-rate	Lãi suất thứ hai
secrecy	bí mật
secretary	Thư ký
secretive	bí mật
sedate	nghiêm trang
sedentary	ít vận động
sediment	trầm tích
sedition	sự xúi giục
seditious	thuộc về sự nổi loạn
seduce	quyến rũ
sedulous	siêng năng
seer	nhà tiên tri
seethe	sôi lên
seignior	lảnh chúa
seismograph	máy đo địa chấn
seize	chiếm
selective	tuyển chọn
self-respect	tự trọng
semblance	sự giả đò
semicivilized	semicivilized
semiconscious	bán tín bán nghi
semiannual	nửa năm
semicircle	bán nguyệt
seminar	Hội thảo
seminary	chủng viện
senile	già yếu
sensation	cảm giác
sense	giác quan
sensibility	nhạy cảm
sensitive	nhạy cảm
sensorium	sensorium
sensual	gợi cảm
sensuous	dâm dật
sentence	kết án
sentience	sự cãm giác
sentient	sinh
sentinel	lính gác
separable	có thể phân chia
separate	tách rời
separatist	ly khai
septennial	bảy năm một lần
sepulcher	mộ làm bằng đá
sequacious	có mạch lạc
sequel	phần tiếp theo
sequence	sự nối tiếp
sequent	liên tiếp
sequester	cô lập
sequestrate	tịch thâu
sergeant	trung sỉ
sergeant-at-arms	trung sĩ-at-arms
sergeant-major	trung sĩ-lớn
service	dịch vụ
serviceable	săn sóc
servitude	hình phạt khổ sai
severance	thôi
severely	tàn khốc
sextet	bản nhạc có sáu ngưới hát
sextuple	gấp sáu lần
sheer	tuyệt đối
shiftless	không có hiệu quả
shrewd	thông minh
shriek	tiếng kêu xé tai
shrinkage	sự co lại
shrivel	teo lại
shuffle	trộn
sibilance	sibilance
sibilant	kêu như còi
sibilate	đọc có tiếng gió
sidelong	xiên
sidereal	thuộc về thiên thể
siege	sự bao vây
significance	ý nghĩa
significant	có ý nghĩa
signification	ý nghĩa
similar	giống
simile	sự so sánh
similitude	sự đối chiếu
simplify	đơn giản hóa
simulate	mô phỏng
simultaneous	cùng một lúc
sinecure	chức ngồi không ăn lương
singe	làm cháy sém
sinister	độc ác
sinuosity	trạng thái khúc khuỷnh
sinuous	quanh co
sinus	xoang
siren	nhân ngư
sirocco	gió đông nam ở địa trung hải
sisterhood	em đở đầu
skeptic	sự hoài nghi
skepticism	hoài nghi
skiff	thuyền nhỏ
skirmish	cuộc đụng độ
sleight	sleight
slight	mảnh dẻ
slothful	biếng nhác
sluggard	người làm biếng
sociable	Hòa đồng
socialism	chủ nghĩa xã hội
socialist	nhà xã hội học
sociology	xã hội học
Sol	nốt sol
solace	lời an ủi
solar	hệ mặt trời
solder	hàn
soldier	lính
solecism	điều lầm lổi
solicitor	cố vấn pháp luật
solicitude	sự lo lắng
soliloquy	người nói một mình
solstice	chí điểm
soluble	hòa tan được
solvent	hòa tan
somber	ảm đạm
somniferous	làm buồn ngũ
somnolence	tình trạng mơ màng
somnolent	mơ màng
sonata	khúc cầm nhạc
sonnet	bài thơ mười bốn câu
sonorous	kêu to
soothsayer	nhà tiên tri
sophism	lối ngụy biện
sophistical	sophistical
sophisticate	pha rượu
sophistry	chủ nghĩa ngụy biện
soprano	soprano
sorcery	yêu thuật
sordid	bẩn thỉu
souvenir	quà lưu niệm
sparse	rải rác
Spartan	Spartan
spasmodic	xảy ra không liên tiếp
specialize	chuyên môn
specialty	chuyên môn
specie	đồng tiền
species	loài
specimen	mẫu
specious	giả dối
spectator	khán giả
specter	ma quỷ
spectrum	quang phổ
speculate	suy đoán
speculator	người hay suy nghĩ
sphericity	cầu thể
spheroid	hình tự cầu
spherometer	spherometer
spinous	spinous
spinster	người đàn bà chưa chồng
spontaneous	tự phát
sprightly	hoạt bát
spurious	giả mạo
squabble	sự gây lộn
squalid	bẩn thỉu
squatter	người ngồi xổm
stagnant	ứ đọng
stagnate	đọng lại
stagnation	trì trệ
stagy	thuộc về sân khấu
staid	nghiêm trang
stallion	ngựa giống
stanchion	cột chống hai bên sườn tàu
stanza	đoạn thơ
statecraft	statecraft
static	tĩnh
statics	sự dẩn điện
stationary	đứng im
statistician	người làm thống kê
statuesque	có hình tượng
statuette	tượng nhỏ
stature	tầm vóc
statute	luật
stealth	lén
stellar	thuộc về sao
steppe	đồng hoang
sterling	sterling
stifle	chết ngộp
stigma	sự kỳ thị
stiletto	dao găm nhỏ
stimulant	chất kích thích
stimulate	kích thích
stimulus	kích thích kinh tế
stingy	bủn xỉn
stipend	lương
Stoicism	chủ nghĩa khắc kỷ
stolid	thản nhiên
strait	hẹp
stratagem	chiến mưu
stratum	stratum
streamlet	suối nhỏ
stringency	sự minh bạch
stringent	nghiêm khắc
stripling	thanh niên
studious	ham học
stultify	làm lố lăng
stupendous	kỳ diệu
stupor	trạng thái tê mê
suasion	sự làm cho phục
suave	ngọt ngào
subacid	subacid
subaquatic	subaquatic
subconscious	tiềm thức
subjacent	ở dưới
subjection	sự chinh phục
subjugate	chinh phục
subliminal	cao siêu
sublingual	dưới lưỡi
submarine	tàu ngầm
submerge	làm ngập
submergence	sự lặn xuống
submersible	chìm
submersion	sự phục tùng
submission	nộp hồ sơ
submittal	đệ trình
subordinate	phụ thuộc
subsequent	tiếp theo
subservience	sự giúp đở
subservient	khép nép
subside	lún xuống
subsist	vẩn tồn tại
subsistence	sự tồn tại
substantive	nội dung
subtend	phép tính
subterfuge	sự thoái thác
subterranean	dưới đất
subtle	tế nhị
subtrahend	số bị trừ
subversion	sự lật đổ
subvert	lật đổ
succeed	thành công
success	sự thành công
successful	thành công
successor	người kế thừa
succinct	gọn gàng
succulent	ngon
succumb	không chống nổi
sufferance	sự đau đớn
sufficiency	sự đầy đủ
suffrage	quyền bỏ phiếu
suffuse	lan ra
suggestible	có thể đề nghị
suggestive	đề nghị
summary	tóm lược
sumptuous	xa hoa
superabundance	sự quá nhiều
superadd	superadd
superannuate	đến tuổi về hưu
superb	tuyệt vời
supercilious	kiêu ngạo
superficial	hời hợt
superfluity	sự không có ích
superfluous	vô dụng
superheat	làm quá nóng
superintend	trông nom
superintendence	sự trông nom
superintendent	người quản lý
superlative	tối thượng
supernatural	siêu nhiên
supernumerary	dư
supersede	THAY THẾ
supine	không hoạt động
supplant	thay thế
supple	dẻo dai
supplementary	bổ sung
supplicant	nài nỉ
supplicate	van xin
supposition	sự giả thiết
suppress	đàn áp
suppressible	suppressible
suppression	sự đàn áp
supramundane	siêu thế
surcharge	phụ phí
surety	người bảo đãm
surfeit	tình trạng quá nhiều
surmise	phỏng đoán
surmount	khắc phục
surreptitious	giấu giếm
surrogate	người đại diện
surround	vây quanh
surveyor	kiểm soát viên
susceptibility	nhạy cảm
susceptible	nhạy cảm
suspense	hồi hộp
suspension	Huyền phù
suspicious	khả nghi
sustenance	đồ ăn
swarthy	sậm màu
Sybarite	dâm dục
sycophant	người nịnh bợ
syllabic	thuộc về vần
syllabication	sự đánh vần
syllable	vần
syllabus	giáo trình
sylph	thần gió
symmetrical	cân đối
symmetry	đối diện
sympathetic	thông cảm
sympathize	thông cảm
symphonic	giao hưởng
symphonious	symphonious
symphony	khúc nhạc
synchronism	tính đồng bộ
syndicate	công đoàn
syneresis	syneresis
synod	hội nghị tôn giáo
synonym	từ đồng nghĩa
synopsis	tóm tắc
systematic	có hệ thống
tableau	phong cảnh trên sân khấu
tacit	Ngấm ngầm
taciturn	trầm mặc
tack	khế ước cho mướn
tact	tact
tactician	nhà chiến thuật
tactics	chiến thuật
tangency	tiếp tuyến
tangent	tiếp tuyến
tangible	hữu hình
tannery	xưởng làm da
tantalize	chọc tức
tantamount	tương đương
tapestry	thảm thêu
tarnish	xỉn
taut	căng thẳng
taxation	thuế
taxidermy	thuật độn xác
technic	technic
technicality	tính cách chuyên môn
technique	kỹ thuật
technography	technography
technology	Công nghệ
teem	teem
telepathy	thần giao cách cãm
telephony	điện thoại
telescope	kính thiên văn
telltale	người hay mách
temerity	tánh khinh suất
temporal	thời gian
temporary	tạm thời
temporize	trì hỏan
tempt	cám dỗ
tempter	người cám dổ
tenacious	ngoan cố
tenant	người thuê nhà
tendency	xu hướng
tenet	giáo lý
tenor	tenor
tense	bẩn quá
tentative	mang tính thăm dò
tenure	nhiệm kỳ
tercentenary	ba trăm năm
termagant	người đàn bà gắt gỏng
terminal	thiết bị đầu cuối
terminate	chấm dứt
termination	chấm dứt
terminus	ga cuối cùng
terrify	Terrify
territorial	lãnh thổ
terse	vắn tắc
testament	di chúc
testator	người để chúc thư
testimonial	giấy chứng nhận
thearchy	thearchy
theism	sự tin tưởng có thượng đế
theocracy	chánh trị thần quyền
theocrasy	theocrasy
theologian	thần học
theological	thần học
theology	khoa thần học
theoretical	lý thuyết
theorist	lý thuyết gia
theorize	làm thành lý luận
thereabout	độ chừng
therefor	do
thermal	nhiệt
thermoelectric	nhiệt điện
thermoelectricity	nhiệt điện
thesis	luận văn
thoroughbred	thuần chủng
thoroughfare	đại lộ
thrall	nô lệ
tilth	sự trồng trọt
timbre	thanh sắc
timorous	hay sợ
tincture	kiến thức sơ sài
tinge	vẻ
tipsy	say
tirade	một tràng
tireless	không mệt mỏi
tiresome	làm mệt nhọc
Titanic	có chất hóa học
toilsome	gian nan
tolerable	có thể chịu được
tolerance	lòng khoan dung
tolerant	chấp thuận
tolerate	tha thứ
toleration	sự chịu được
topography	địa hình
torpor	sự hôn mê
torrid	nóng như thiêu
tortious	có hại
tortuous	quanh co
torturous	torturous
tractable	dể làm
trait	đặc điểm
trajectory	quỹ đạo
trammel	dây xích chân ngựa
tranquil	yên lặng
tranquilize	làm cho yên lòng
tranquility	Yên bình
transalpine	transalpine
transact	giao dịch buôn bán
transatlantic	xuyên Đại Tây Dương
transcend	Transcend
transcendent	siêu việt
transcontinental	xuyên qua đại lục
transcribe	Phiên âm
transcript	bảng điểm
transfer	chuyển khoản
transferable	chuyển nhượng
transferee	chuyển nhượng
transference	Sự chuyển di
transferrer	transferrer
transfigure	biến hình
transfuse	chuyển đồ sang
transfusible	transfusible
transfusion	truyền
transgress	vi phạm
transience	tính tạm thời
transient	tạm thời
transition	chuyển tiếp
transitory	tạm thời
translate	Phiên dịch
translator	thông dịch viên
translucence	mờ
translucent	trong suốt
transmissible	di truyền
transmission	quá trình lây truyền
transmit	chuyển giao
transmute	transmute
transparent	trong suốt
transpire	toát mồ hôi
transplant	cấy
transposition	sự chuyển điệu
transverse	ngang
travail	công việc vất vả
travesty	sự bắt chước đùa
treacherous	phụ bạc
treachery	sự phản bội
treasonable	thuộc về mưu phản
treatise	khái niệm
treble	gấp ba
trebly	trebly
tremendous	rất lớn
tremor	rung chuyen
tremulous	run
trenchant	đanh thép
trepidation	sự rung chuyển
trestle	cái giá
triad	bộ ba
tribune	diển đàn
trickery	sự đánh lừa
tricolor	ba màu
tricycle	xe ba bánh
trident	chĩa ba
triennial	kéo dài trong ba năm
trimness	trimness
trinity	bộ đồ ba món
trio	bộ ba
triple	gấp ba
triplicate	ba lần
triplicity	triplicity
tripod	giá ba chân
trisect	chia làm ba phần bằng nhau
trite	tầm thường
triumvir	chấp chánh ở trong tam đầu chế la mã
trivial	không đáng kể
troublesome	khó khăn
truculence	tánh hung dữ
truculent	dữ tợn
truism	sự thật đương nhiên
truthful	đúng sự thật
turgid	cương lên
turpitude	sự sĩ nhục
tutelage	thời gian giám hộ
tutelar	thuộc về giám hộ
tutorship	phương pháp dạy riêng
twinge	làm đau nhức
typical	điển hình
typify	tiêu biểu
typographical	in ấn
typography	typography
tyrannical	tàn bạo
tyranny	chuyên chế
tyro	người mới vào nghề
ubiquitous	phổ cập
ulterior	Thâm kin
ultimate	tối thượng
ultimatum	tối hậu thơ
ultramundane	ultramundane
ultramontane	ultramontane
umbrage	bóng cây
unaccountable	tánh kỳ khôi
unaffected	chân thật
unanimous	nhất trí
unanimity	trạng thái toàn thể
unavoidable	không thể tránh được
unbearable	không thể chịu nổi
unbecoming	không thích hợp
unbelief	sự không tin
unbiased	không thiên vị
unbridled	không cương
uncommon	không thông dụng
unconscionable	không hết lòng
unconscious	vô ý thức
unction	sự bôi
unctuous	lẻo mép
undeceive	khỏi bị lường gạt
undercharge	sự nạp không đủ sức
underexposed	thiếu sáng
undergarment	lót
underman	underman
undersell	bán rẻ
undersized	cở nhỏ nhất
underhanded	bất chánh
underlie	nền tảng
underling	thuộc hạ
undermine	hủy hoại
underrate	trị giá quá thấp
understate	không đủ
undervalue	đánh giá thấp
underworld	thế giới ngầm
underwrite	bảo hiểm
undue	Thái quá
undulate	undulate
undulous	undulous
unfavorable	bất lợi
ungainly	vô duyên
unguent	thuốc cao
unicellular	đơn bào
univalence	univalence
unify	Unify
unique	độc nhất
unison	unison
unisonant	unisonant
Unitarian	Unitarian
unlawful	bất hợp pháp
unlimited	vô hạn
unnatural	không tự nhiên
unnecessary	không cần thiết
unsettle	làm lung lay
unsophisticated	không kinh nghiệm
unspeakable	không thể nói
untimely	không kịp thời
untoward	không thuận tiện
unutterable	không thể tả được
unwieldy	khó di chuyển
unwise	không thận trọng
unyoke	nghỉ ngơi
up-keep	up-giữ
upbraid	khiển trách
upcast	bị ném lên trời
upheaval	sự thay đổi
upheave	nâng lên
uppermost	quan trọng hơn hết
uproarious	náo nhiệt
uproot	bứng rể
upturn	sự cải thiện
urban	đô thị
urbanity	lể độ
urchin	đứa bé láu cá
urgency	khẩn cấp
usage	sử dụng
usurious	cho vay nặng lải
usurp	chiếm đoạt
usury	cho vay cắt cổ
utilitarianism	chủ nghĩa thực dụng
utility	hữu dụng
utmost	hết sức
vacate	bỏ trống
vaccinate	chủng đậu
vacillate	lung lay
vacuous	trống
vacuum	máy hút bụi
vagabond	người vô nghề nghiệp
vagrant	rày đây mai đó
vainglory	hư vinh
vale	thung lũng
valediction	tiển hành
valedictorian	thủ khoa
valedictory	bài diển văn
valid	có hiệu lực
valorous	dũng cảm
vapid	không hứng thú
vaporizer	vaporizer
variable	Biến đổi
variance	đúng
variant	biến thể
variation	sự thay đổi
variegate	làm cho màu sắc khác nhau
vassal	chư hầu
vaudeville	đại nhạc hội
vegetal	thực vật
vegetarian	ăn chay
vegetate	sống một cách buồn chán
vegetation	thảm thực vật
vegetative	thực vật
vehement	kịch liệt
velocity	vận tốc
velvety	mịn như nhung
venal	dể hối lộ
vendible	có thể bán được
vendition	vendition
vendor	người bán
veneer	ván lạng
venerable	đáng kính
venerate	tôn kính
venereal	thuộc bịnh hoa liểu
venial	lỗi có thể tha thứ được
venison	thịt nai
venom	nọc độc
venous	tĩnh mạch
veracious	thật thà
veracity	sự thật thà
verbatim	từng tiếng một
verbiage	sự nói dài giòng
verbose	rườm rà
verdant	cỏ xanh tươi
verification	xác minh
verify	kiểm chứng
verily	quả thật
verity	tính cách thật sự
vermin	quân vô lại
vernacular	tiếng bản xứ
vernal	thuộc về mùa xuân
versatile	linh hoạt
version	phiên bản
vertex	đỉnh đầu
vertical	theo chiều dọc
vertigo	sự chóng mặt
vestige	vết tích
vestment	lớp tô ở ngoài
veto	phủ quyết
vicarious	do người khác làm
viceroy	phó vương
vicissitude	cuộc thăng trầm
vie	vie
vigilance	cảnh giác
vigilant	cẩn thận
vignette	in màu
vincible	có thể vượt qua
vindicate	binh vực
vindicatory	để biện hộ
vindicative	để bào chừa
vinery	vinery
viol	một thứ vĩ cầm
viola	cây tử la lan
violator	người vi phạm
violation	sự vi phạm
violoncello	đàn vi ô lông xen
virago	người đàn bà hay gắt gỏng
virile	dương vật
virtu	thích đồ cổ
virtual	ảo
virtuoso	đồ mỹ thuật
virulence	tính độc
virulent	hiểm độc
visage	mặt
viscount	tử tước
vista	vista
visual	trực quan
visualize	hình dung
vitality	sức sống
vitalize	Vitalize
vitiate	làm hỏng
vituperable	vituperable
vivacity	sự nhanh nhẩu
vivify	làm linh động
vivisection	thuật giải phẩu sinh thể
vocable	danh từ
vocative	xưng hô
vociferance	vociferance
vociferate	la lối om sòm
vociferous	la lối om sòm
vogue	vogue
volant	bay
volatile	bay hơi
volition	ý
volitive	volitive
voluble	ăn nói hoạt bát
voluptuous	khiêu dâm
voracious	tham ăn
vortex	xoáy nước
votary	người hâm mộ
votive	do phát thệ
vulgarity	tánh thường
vulnerable	dễ bị tổn thương
waif	không nhà không cửa
waistcoat	áo nịt
waive	từ bỏ
wampum	chuổi làm bằng vỏ sò
wane	tuần trăng khuyết
wantonness	sự đùa cợt
warlike	hùng dũng
wavelet	lằn gợn lăn tăn
weak-kneed	nhu nhược
weal	hạnh phúc
wean	cai sữa
wearisome	mệt mỏi
wee	rất nhỏ
well-bred	có giáo dục
well-doer	người có đức hạnh
well-to-do	thời gian tốt
whereabouts	nơi
whereupon	trên ấy
wherever	bất cứ nơi nào
wherewith	bằng vật gì
whet	mài
whimsical	hay thay đổi
whine	tiếng rên rỉ
wholly	hoàn toàn
wield	vận dụng
wile	mưu chước
winsome	hấp dẫn
wintry	như mùa đông
wiry	tiếng sang sảng
witchcraft	ma thuật
witless	Witless
witling	witling
witticism	witticism
wittingly	ý nhị
wizen	nhăn nheo
wizen-faced	nhăn nheo có khuôn mặt
working-man	lao động con người
workmanlike	như người thợ
workmanship	khéo léo
wrangle	học sinh đậu hạng nhứt
wreak	làm cho hả
wrest	Wrest
wretchedness	khốn
writhe	sự vặn vẹo
writing	viết
wry	bị vặn
yearling	thời gian một năm
zealot	người có nhiệt tình
zeitgeist	chiều hướng suy nghĩ
zenith	thiên đình
zephyr	một thứ vải mỏng
zodiac	hoàng đạo
